//MAP CONVERTED BY dmm2tgm.py THIS HEADER COMMENT PREVENTS RECONVERSION, DO NOT REMOVE
"a" = (
/turf/closed/indestructible/rock/snow/ice,
/area/space)
"d" = (
/turf/open/misc/ice,
/area/space)
"h" = (
/obj/structure/window/spawner/directional/east,
/obj/structure/window/spawner/directional/west,
/turf/open/floor/wood,
/area/space)
"i" = (
/turf/open/floor/wood,
/area/space)
"j" = (
/turf/open/floor/iron/freezer,
/area/space)
"k" = (
/obj/structure/window/reinforced/fulltile/ice{
	name = "frozen window"
	},
/turf/open/floor/plating,
/area/space)
"l" = (
/turf/closed/wall/mineral/wood/nonmetal,
/area/space)
"n" = (
/obj/structure/closet/secure_closet/freezer/fridge/open,
/obj/item/reagent_containers/condiment/mayonnaise,
/turf/open/floor/iron/freezer,
/area/space)
"o" = (
/turf/open/cliff/snowrock{
	name = "Icy cliff"
	},
/area/space)
"s" = (
/obj/structure/fireplace,
/turf/open/floor/carpet,
/area/space)
"y" = (
/obj/structure/table/wood,
/turf/open/floor/wood,
/area/space)
"B" = (
/obj/machinery/door/airlock/wood/glass{
	name = "Cabin"
	},
/turf/open/floor/wood,
/area/space)
"D" = (
/turf/open/lava/plasma/virtual_domain,
/area/space)
"E" = (
/turf/open/misc/asteroid/snow/snow_cabin,
/area/space)
"G" = (
/obj/machinery/gibber,
/turf/open/floor/iron/freezer,
/area/space)
"H" = (
/turf/open/floor/carpet,
/area/space)
"J" = (
/obj/structure/table/wood/fancy,
/turf/closed/wall/mineral/wood/nonmetal,
/area/space)
"M" = (
/obj/structure/table/wood/fancy,
/turf/open/floor/wood,
/area/space)
"N" = (
/turf/open/floor/iron/kitchen,
/area/space)
"O" = (
/obj/machinery/door/airlock/wood{
	name = "Sauna"
	},
/turf/open/floor/wood,
/area/space)
"R" = (
/obj/structure/kitchenspike,
/turf/open/floor/iron/freezer,
/area/space)
"S" = (
/obj/machinery/processor,
/turf/open/floor/iron/freezer,
/area/space)
"T" = (
/turf/open/floor/plating/snowed/smoothed,
/area/space)
"V" = (
/turf/open/floor/iron/stairs,
/area/space)
"W" = (
/obj/effect/baseturf_helper/asteroid/snow,
/turf/closed/indestructible/rock/snow/ice,
/area/space)

(1,1,1) = {"
a
a
a
a
a
a
a
a
a
a
a
a
a
a
a
a
a
a
a
a
a
a
a
a
a
a
a
a
a
a
a
a
a
a
a
a
a
a
a
a
a
a
a
a
a
a
a
a
a
a
a
a
a
a
a
a
a
a
a
a
a
a
a
a
a
a
a
a
a
a
a
a
a
a
a
a
a
a
a
a
a
a
a
a
a
a
a
a
a
a
a
a
a
a
a
a
a
a
a
W
"}
(2,1,1) = {"
a
E
E
E
E
E
E
E
E
E
E
E
E
E
E
E
E
E
E
E
o
o
o
o
o
o
o
o
o
o
E
E
E
E
E
E
E
E
E
E
E
E
E
E
E
E
E
E
E
E
E
E
E
E
E
E
E
E
E
E
o
o
o
o
o
o
o
o
o
o
E
a
a
a
a
a
a
a
a
a
a
a
a
a
a
a
a
a
a
a
a
a
a
a
a
a
a
a
a
a
"}
(3,1,1) = {"
a
E
E
E
E
E
E
E
E
E
E
E
E
E
E
E
E
E
E
E
o
o
o
o
o
o
o
o
o
o
E
l
l
l
l
l
l
l
l
l
l
l
l
l
l
l
l
l
l
l
l
l
l
l
l
l
l
l
E
E
o
o
o
o
o
o
o
o
o
o
E
E
a
a
a
a
a
a
a
E
E
E
E
a
a
a
a
a
a
a
E
a
a
a
a
a
a
a
a
a
"}
(4,1,1) = {"
a
E
E
E
E
E
E
E
E
E
E
E
E
E
E
E
E
E
E
E
o
o
o
o
o
o
o
o
o
o
E
l
j
j
j
j
l
i
i
l
G
n
S
l
N
N
N
N
l
i
i
i
i
l
i
y
i
l
l
E
o
o
o
o
o
o
o
o
o
o
E
E
E
a
a
a
a
a
E
E
E
E
E
E
E
E
E
E
E
E
E
E
E
a
a
a
a
E
E
a
"}
(5,1,1) = {"
a
E
E
E
E
E
E
E
E
E
E
E
E
E
E
E
E
E
E
E
o
o
o
o
o
o
o
o
o
o
E
l
l
j
l
l
l
i
i
l
R
j
j
j
N
N
N
N
l
i
i
i
i
M
i
i
i
i
k
E
o
o
o
o
o
o
o
o
o
o
E
E
E
E
a
a
a
E
E
E
E
E
E
E
E
E
E
E
E
E
E
E
E
E
E
E
E
E
E
a
"}
(6,1,1) = {"
a
E
E
E
E
E
E
E
E
E
E
E
E
E
E
E
E
E
E
E
E
o
o
o
o
o
o
o
o
o
E
k
i
i
i
i
l
i
i
l
l
l
l
l
N
N
N
N
l
i
i
i
i
M
i
i
i
y
k
E
o
o
o
o
o
o
o
o
o
o
E
E
E
E
E
a
E
E
E
E
E
E
E
E
E
E
E
E
E
E
E
E
E
E
E
E
E
E
E
a
"}
(7,1,1) = {"
a
E
E
E
E
E
E
E
E
E
E
E
E
E
E
E
E
E
E
E
E
o
o
o
o
o
o
o
o
o
E
k
i
i
i
i
l
i
i
i
i
i
i
l
N
N
N
N
i
i
i
i
i
M
i
i
i
i
k
E
o
o
o
o
o
o
o
o
o
o
E
E
E
E
E
E
E
E
E
E
E
E
E
E
E
E
E
E
E
E
E
E
E
E
E
E
E
E
E
a
"}
(8,1,1) = {"
a
E
E
E
E
E
E
E
E
E
E
E
E
E
E
E
E
E
E
E
E
o
o
o
o
o
o
o
o
o
E
k
i
i
i
i
i
i
i
i
i
i
i
l
N
N
N
N
l
i
i
i
i
M
i
y
i
i
k
E
o
o
o
o
o
o
o
o
o
E
E
E
E
E
E
E
E
E
E
E
E
E
E
E
E
E
E
E
E
E
E
E
E
E
E
E
E
E
E
a
"}
(9,1,1) = {"
a
E
E
E
E
E
E
E
E
E
E
E
E
E
E
E
E
E
E
E
E
o
o
o
o
o
o
o
o
o
E
l
l
l
l
l
l
i
i
i
i
i
i
l
l
l
i
l
l
l
M
J
J
l
i
i
i
i
k
E
o
o
o
o
o
o
o
o
o
E
E
E
E
E
E
E
E
E
E
E
E
E
E
E
E
E
E
E
E
E
E
E
E
E
E
E
E
E
a
a
"}
(10,1,1) = {"
a
E
E
E
E
E
E
E
E
E
E
E
E
E
E
E
E
E
E
E
E
o
o
o
o
o
o
o
o
o
E
k
i
i
i
i
i
i
i
i
i
i
i
l
i
i
i
i
l
i
i
i
i
i
i
i
i
y
k
E
o
o
o
o
o
o
o
o
o
E
E
E
E
E
E
E
E
E
E
E
E
E
E
E
E
E
E
E
E
E
E
E
E
E
E
E
E
a
a
a
"}
(11,1,1) = {"
a
E
E
E
E
E
E
E
E
E
E
E
E
E
E
E
E
E
E
E
E
E
o
o
o
o
o
o
o
o
E
k
i
i
i
i
l
i
i
l
h
h
h
l
i
i
i
i
l
i
i
i
i
i
i
i
i
i
k
E
o
o
o
o
o
o
o
o
E
E
E
E
E
E
E
E
E
E
E
E
E
E
E
E
E
E
E
E
E
E
E
E
E
E
E
E
E
a
a
a
"}
(12,1,1) = {"
a
E
E
E
E
E
E
E
E
E
E
E
E
E
E
E
E
E
E
E
E
E
E
o
o
o
o
o
o
o
E
k
i
i
i
i
l
i
i
i
i
i
i
i
i
i
i
i
i
i
i
i
i
i
i
i
i
i
k
E
o
o
o
o
o
o
o
o
E
E
E
E
E
E
E
E
E
E
E
a
a
E
E
E
E
a
a
E
E
a
a
a
E
E
E
E
E
E
a
a
"}
(13,1,1) = {"
a
E
E
E
E
E
E
E
E
E
E
E
E
E
E
E
E
E
E
E
E
E
E
o
o
o
o
o
o
o
E
l
l
j
l
l
l
i
i
i
i
i
i
i
i
i
i
i
i
i
i
i
i
i
i
i
i
i
k
E
o
o
o
o
o
o
o
o
d
E
E
E
E
E
E
E
E
E
a
a
a
a
a
a
a
a
a
a
a
a
D
a
a
a
E
E
E
E
a
a
"}
(14,1,1) = {"
a
E
E
E
E
E
E
E
E
E
E
E
E
E
E
E
E
E
E
E
o
o
E
o
o
o
o
o
o
o
E
l
j
j
j
j
l
i
i
i
i
i
i
i
i
i
i
i
l
i
i
i
i
i
i
i
i
l
l
E
o
o
o
o
o
o
o
o
d
E
E
o
E
E
E
E
E
a
a
a
a
a
a
a
a
a
a
a
a
D
D
D
D
a
a
E
E
E
E
a
"}
(15,1,1) = {"
a
E
E
E
E
E
E
E
E
E
E
E
E
E
E
E
E
E
E
E
o
o
o
o
o
o
o
o
o
o
E
l
l
l
l
l
l
O
l
l
i
i
i
i
i
i
i
i
l
k
k
k
l
k
k
k
l
l
E
E
o
o
o
o
o
o
o
E
E
E
d
o
E
E
E
E
E
a
a
a
a
a
a
a
a
a
D
D
D
D
D
a
a
a
a
a
E
E
E
a
"}
(16,1,1) = {"
a
E
E
E
E
E
E
E
E
E
E
E
E
E
E
E
E
E
E
E
o
o
o
o
o
o
o
o
o
o
E
E
E
E
E
l
i
i
i
l
l
i
i
i
i
i
i
i
l
E
E
E
E
E
E
E
E
E
E
o
o
o
o
o
o
o
E
E
E
E
o
o
E
E
E
E
a
a
a
E
E
E
D
D
a
D
D
D
D
D
a
a
a
a
a
a
a
a
a
a
"}
(17,1,1) = {"
a
E
E
E
E
E
E
E
E
E
E
E
E
E
E
E
E
E
E
E
o
o
o
o
o
o
o
o
o
o
o
o
o
o
E
l
i
i
i
l
l
l
l
l
O
O
l
l
l
E
E
E
E
E
E
E
E
E
E
o
o
o
o
o
o
E
d
E
E
o
o
o
E
E
E
a
a
E
E
E
E
D
D
D
D
D
D
D
D
a
a
a
a
a
a
a
a
a
a
a
"}
(18,1,1) = {"
a
E
E
E
E
E
E
E
E
E
E
E
E
E
E
E
E
E
E
E
E
E
E
E
E
E
o
o
o
o
o
o
o
o
E
l
i
i
i
l
E
E
l
i
i
i
i
l
E
E
o
o
o
o
o
o
o
o
o
o
o
o
o
o
d
E
E
E
E
o
o
E
E
E
E
E
E
E
E
E
D
D
D
D
D
D
D
D
D
a
a
a
a
a
a
a
a
a
a
a
"}
(19,1,1) = {"
a
E
E
E
E
E
E
E
E
E
E
E
E
E
E
E
E
E
E
E
E
E
E
E
E
E
E
E
E
o
o
o
o
o
E
l
i
i
i
l
E
E
l
i
i
i
i
l
E
E
o
o
o
o
o
o
o
o
o
o
o
o
o
o
E
E
E
E
d
o
o
E
E
E
E
E
E
E
E
E
D
D
D
D
D
D
D
D
a
a
a
a
a
a
a
a
a
a
a
a
"}
(20,1,1) = {"
a
E
E
E
E
E
E
E
E
E
E
E
E
E
E
E
E
E
E
E
E
E
E
E
E
E
E
E
E
E
E
o
o
o
E
l
l
l
l
l
E
E
l
l
O
O
l
l
E
o
o
o
o
o
o
o
o
o
o
o
o
o
o
E
E
E
E
E
o
o
o
E
E
E
E
E
E
E
E
E
E
D
D
D
D
D
D
a
a
a
a
a
a
a
a
a
a
a
a
a
"}
(21,1,1) = {"
a
E
E
E
E
E
E
E
E
E
E
E
E
E
E
E
E
E
E
E
E
E
E
E
E
E
E
E
E
E
E
o
o
o
E
E
E
E
E
E
E
E
E
E
E
E
E
E
E
o
o
o
o
o
o
o
E
V
V
V
V
V
E
E
E
E
E
o
o
o
d
E
E
E
E
E
d
d
E
E
D
D
D
D
D
D
D
a
a
a
a
a
a
a
a
a
a
a
a
a
"}
(22,1,1) = {"
a
E
E
E
E
E
E
E
E
E
E
E
E
E
E
E
E
E
E
E
E
E
E
E
E
E
E
E
E
E
E
o
o
o
o
o
o
o
o
o
o
o
o
o
E
E
E
o
o
o
o
o
o
o
o
o
E
V
V
V
V
V
E
d
E
E
d
o
o
o
d
E
E
E
E
E
E
E
E
D
D
D
D
D
D
D
a
a
a
a
a
a
a
a
a
a
a
a
a
a
"}
(23,1,1) = {"
a
E
E
E
E
E
E
E
E
E
E
E
E
E
E
E
E
E
E
E
E
E
E
E
E
E
E
E
E
E
E
o
o
o
o
o
o
o
o
o
o
o
o
o
E
E
E
o
o
o
o
o
o
o
o
o
E
V
V
V
V
V
E
E
d
E
E
o
o
E
d
E
E
E
E
E
E
E
D
D
D
D
D
D
D
a
a
a
a
a
a
a
a
a
a
a
a
a
a
a
"}
(24,1,1) = {"
a
E
E
E
E
E
E
E
E
E
E
E
E
E
E
E
E
E
E
E
E
E
E
E
E
E
E
E
E
E
E
E
o
o
o
o
o
o
o
o
o
o
o
o
o
E
E
E
o
o
o
o
o
o
o
E
E
o
o
o
o
o
E
E
E
E
T
o
o
E
d
E
E
E
E
E
E
D
D
D
D
D
D
a
a
a
a
a
a
a
a
a
a
a
a
a
a
a
a
a
"}
(25,1,1) = {"
a
E
E
E
E
E
E
E
E
E
E
E
E
E
E
E
E
E
E
E
E
E
E
E
E
E
E
E
E
E
E
E
o
o
o
o
o
o
o
o
o
o
o
o
o
o
E
E
o
o
o
o
o
o
o
E
E
o
o
o
o
o
d
E
E
E
o
o
o
o
E
E
E
E
E
E
E
E
D
D
D
D
D
a
a
a
a
a
a
a
a
a
a
a
a
a
a
a
a
a
"}
(26,1,1) = {"
a
E
E
E
E
E
E
E
E
E
E
E
E
E
E
E
E
E
E
E
E
E
E
E
E
E
E
E
E
E
E
E
E
E
o
o
o
o
o
o
o
o
o
o
o
o
E
E
o
o
o
o
o
o
o
E
o
o
o
o
o
o
E
E
E
d
o
o
o
o
o
E
E
E
d
E
E
E
E
D
D
D
D
a
a
a
a
a
D
D
D
a
a
a
a
a
a
a
a
a
"}
(27,1,1) = {"
a
E
E
E
E
E
E
E
E
E
E
E
E
E
E
E
E
E
E
E
E
E
E
E
E
E
E
E
E
E
E
E
E
E
o
o
o
o
o
o
o
o
o
V
V
V
E
E
E
o
o
o
o
o
o
E
o
o
o
o
o
o
d
E
E
d
o
o
o
o
o
E
E
E
E
E
E
E
E
E
D
D
D
a
a
a
a
a
D
D
D
D
a
a
a
a
a
a
a
a
"}
(28,1,1) = {"
a
E
E
E
E
E
E
E
E
E
E
E
E
E
E
E
E
E
E
E
E
E
E
E
E
E
E
E
E
E
E
E
E
E
o
o
o
o
o
o
E
V
V
V
V
V
E
E
E
o
o
o
o
o
o
E
o
o
o
o
o
o
o
E
E
E
o
o
o
o
o
o
o
E
E
E
E
E
E
E
o
D
D
D
D
D
D
D
D
D
D
D
a
a
a
a
a
a
a
a
"}
(29,1,1) = {"
a
E
E
E
E
E
E
E
E
E
E
E
E
E
E
E
E
E
E
E
E
E
E
E
E
E
E
E
E
E
E
E
E
E
o
o
o
o
o
E
E
V
V
V
o
o
E
E
E
E
o
o
o
o
o
E
o
o
o
o
o
o
o
E
E
E
o
o
o
o
o
o
o
o
E
E
o
E
E
o
o
D
D
D
D
D
D
D
D
D
D
E
E
a
a
a
a
a
a
a
"}
(30,1,1) = {"
a
E
E
E
E
E
E
E
E
E
E
E
E
E
E
E
E
E
E
E
E
E
E
E
E
E
E
E
E
E
E
E
E
E
o
o
o
o
o
E
E
o
o
o
o
o
o
o
E
E
V
V
V
V
V
E
o
o
o
o
o
o
o
o
E
E
o
o
o
o
o
o
o
o
E
E
o
o
o
o
o
E
E
D
D
D
D
E
E
E
E
E
E
E
E
a
a
a
a
a
"}
(31,1,1) = {"
a
E
E
E
E
E
E
E
E
E
E
E
E
E
E
E
E
E
E
E
E
E
E
E
E
E
E
E
E
E
E
E
E
E
o
o
o
o
o
E
E
o
o
o
o
o
o
o
o
E
V
V
V
V
V
o
o
o
o
o
o
o
o
o
E
E
d
o
o
o
o
o
o
o
E
o
o
o
o
o
o
E
E
E
D
D
D
D
D
E
E
E
E
E
E
E
E
a
a
a
"}
(32,1,1) = {"
a
E
E
E
E
E
E
E
E
E
E
E
E
E
E
E
E
E
E
E
E
E
E
E
E
E
E
E
E
E
E
E
E
E
o
o
o
o
o
E
E
o
o
o
o
o
o
o
o
o
o
o
o
o
o
o
o
o
o
o
o
o
o
o
d
E
E
o
o
o
o
o
o
o
o
o
o
o
o
o
o
o
E
E
E
E
E
D
D
D
E
E
E
E
E
E
E
E
a
a
"}
(33,1,1) = {"
a
E
E
E
E
E
E
E
E
E
E
E
E
E
E
E
E
E
E
E
E
E
E
E
E
E
E
E
E
E
E
E
E
E
o
o
o
o
o
E
o
o
o
o
o
o
o
o
o
o
o
E
o
o
o
o
o
o
o
o
o
o
o
o
o
E
E
E
o
o
o
o
o
o
o
o
o
o
o
o
o
o
E
E
E
E
E
D
D
D
E
E
E
E
E
E
E
E
E
a
"}
(34,1,1) = {"
a
E
E
E
E
E
E
E
E
E
E
E
E
E
E
E
E
E
E
E
E
E
E
E
E
E
E
E
E
E
E
E
E
E
o
o
o
o
o
E
o
o
o
o
o
o
o
o
o
o
o
E
o
o
o
o
o
o
o
o
o
o
o
o
o
o
T
E
o
o
o
o
o
o
o
o
o
o
o
o
o
o
o
E
E
E
E
E
E
D
D
E
E
E
E
E
E
E
E
a
"}
(35,1,1) = {"
a
E
E
E
E
E
E
E
E
E
E
E
E
E
E
E
E
E
E
E
E
E
E
E
E
E
E
E
E
E
E
E
E
E
o
o
o
o
E
E
o
o
o
o
o
o
o
o
o
o
o
E
o
o
o
o
o
o
o
o
o
o
o
o
o
o
T
E
E
o
o
o
o
o
o
o
o
o
o
o
o
o
o
E
E
E
E
E
E
E
E
E
E
E
E
E
E
E
E
a
"}
(36,1,1) = {"
a
E
E
E
E
E
E
E
E
E
E
E
E
E
E
E
E
E
E
E
E
E
E
E
E
E
E
E
E
E
E
E
E
E
o
o
o
o
E
E
o
o
o
o
o
o
o
o
o
o
o
o
o
o
o
o
o
o
o
o
o
o
o
o
o
o
o
E
E
E
o
o
o
o
o
o
o
o
o
o
o
o
E
E
E
E
E
E
E
E
E
E
E
E
E
E
E
E
E
a
"}
(37,1,1) = {"
a
E
E
E
E
E
E
E
E
E
E
E
E
E
E
E
E
E
E
E
E
E
E
E
E
E
E
E
E
E
E
E
E
E
o
o
o
o
o
E
V
V
V
V
V
V
V
V
V
E
o
o
o
o
o
o
o
o
o
o
o
o
o
o
o
o
o
E
E
d
E
o
o
o
o
o
o
o
o
o
o
o
E
E
E
E
E
E
E
E
E
E
E
E
E
E
E
E
E
a
"}
(38,1,1) = {"
a
E
E
E
E
E
E
E
E
E
E
E
E
E
E
E
E
E
E
E
E
E
E
E
E
E
E
E
E
E
E
E
E
E
E
o
o
o
o
E
V
V
V
V
V
V
V
V
V
E
E
o
o
o
o
o
o
o
o
o
o
o
o
o
o
o
o
o
E
E
E
E
o
o
o
E
o
o
o
o
o
o
o
E
E
E
E
E
E
E
E
E
E
E
E
E
E
E
E
a
"}
(39,1,1) = {"
a
E
E
E
E
E
E
E
E
E
E
E
E
E
E
E
E
E
E
E
E
E
E
E
E
E
E
E
E
E
E
E
E
E
E
o
o
o
o
o
o
o
o
o
o
o
o
o
o
E
E
o
o
o
o
o
o
o
o
o
o
o
o
o
o
o
o
o
o
E
E
T
E
V
V
E
T
o
o
o
o
o
o
o
E
E
E
E
E
E
E
E
E
E
E
E
E
E
E
a
"}
(40,1,1) = {"
a
E
E
E
E
E
E
E
E
E
E
E
E
E
E
E
E
E
E
E
E
E
E
E
E
E
E
E
E
E
E
E
E
E
E
E
o
o
o
o
o
o
o
o
o
o
o
o
o
E
E
o
o
o
o
o
o
o
o
o
o
o
o
o
o
o
o
o
o
o
d
E
E
V
V
d
E
o
o
o
o
o
o
o
E
E
E
E
E
E
E
E
E
E
E
E
E
E
E
a
"}
(41,1,1) = {"
a
E
E
E
E
E
E
E
E
E
E
E
E
E
E
E
E
E
E
E
E
E
E
E
E
E
E
E
E
E
E
E
E
E
E
E
o
o
o
o
o
o
o
o
o
o
o
o
o
E
E
V
V
V
V
V
V
V
V
E
E
E
o
o
o
o
o
o
o
o
d
E
E
V
V
E
E
E
o
o
o
o
o
o
E
E
E
E
E
E
E
E
E
E
E
E
E
E
E
a
"}
(42,1,1) = {"
a
E
E
E
E
E
E
E
E
E
E
E
E
E
E
E
E
E
E
E
E
E
E
E
E
E
E
E
E
E
E
E
E
E
E
E
E
o
o
o
o
o
o
o
o
o
o
o
o
E
E
V
V
V
V
V
V
V
V
E
E
E
E
o
o
o
o
o
o
o
o
o
o
o
o
E
T
E
d
o
o
o
o
o
E
E
E
E
E
E
E
l
l
k
k
k
l
l
l
a
"}
(43,1,1) = {"
a
E
E
E
E
E
E
E
E
E
E
E
E
E
E
E
E
E
E
E
E
E
E
E
E
E
E
E
E
E
E
E
E
E
E
E
E
E
E
o
o
o
E
o
o
o
o
o
o
E
o
o
o
o
o
o
o
o
o
o
o
E
E
o
o
o
o
o
o
o
o
o
o
o
o
o
E
d
E
o
o
o
o
E
E
E
E
E
E
E
E
l
H
H
i
i
i
i
l
a
"}
(44,1,1) = {"
a
E
E
E
E
E
E
E
E
E
E
E
E
E
E
E
E
E
E
E
E
E
E
E
E
E
E
E
E
E
E
E
E
E
E
E
E
E
E
E
E
E
E
o
o
o
o
E
E
E
o
o
o
o
o
o
o
o
o
o
o
E
E
o
o
o
o
o
o
o
o
o
o
o
o
o
E
E
E
o
o
o
o
E
E
E
E
E
E
E
E
l
s
H
i
i
i
i
l
a
"}
(45,1,1) = {"
a
E
E
E
E
E
E
E
E
E
E
E
E
E
E
E
E
E
E
E
E
E
E
E
E
E
E
E
E
E
E
E
E
E
E
E
E
E
E
E
E
E
E
o
o
o
E
E
E
E
E
o
o
o
o
o
o
o
o
o
o
E
E
o
o
o
o
o
o
o
o
o
o
o
o
d
E
E
E
V
V
V
V
T
T
E
T
T
E
T
T
l
H
H
i
i
i
i
l
a
"}
(46,1,1) = {"
a
E
E
E
E
E
E
E
E
E
E
E
E
E
E
E
E
E
E
E
E
E
E
E
E
E
E
E
E
E
E
E
E
E
E
E
E
E
E
E
E
E
o
o
o
E
E
E
E
E
E
E
o
o
o
o
o
o
o
o
o
E
E
o
o
o
o
o
o
o
o
o
o
o
o
E
E
d
E
V
V
V
V
E
E
T
E
T
T
T
E
B
i
i
i
i
i
i
l
a
"}
(47,1,1) = {"
a
E
E
E
E
E
E
E
E
E
E
E
E
E
E
E
E
E
E
E
E
E
E
E
E
E
E
E
E
E
E
E
E
E
E
E
E
E
E
E
E
E
o
o
o
E
E
E
E
E
E
E
o
o
o
o
o
o
o
o
o
o
E
E
o
o
o
o
o
o
o
o
o
o
o
T
E
E
T
V
V
V
V
E
E
T
d
E
T
T
E
l
i
i
i
i
i
i
l
a
"}
(48,1,1) = {"
a
E
E
E
E
E
E
E
E
E
E
E
E
E
E
E
E
E
E
E
E
E
E
E
E
E
E
E
E
E
E
E
E
E
E
E
E
E
E
E
E
E
o
o
o
E
E
E
E
E
E
E
o
o
o
o
o
o
o
o
o
o
i
i
o
o
o
o
o
o
o
o
o
o
o
o
E
E
T
o
o
o
o
E
E
E
E
E
E
E
E
l
i
i
i
i
i
i
l
a
"}
(49,1,1) = {"
a
E
E
E
E
E
E
E
E
E
E
E
E
E
E
E
E
E
E
E
E
E
E
E
E
E
E
E
E
E
E
E
E
E
E
E
E
E
E
E
E
E
E
o
o
E
E
E
E
E
E
o
o
o
o
o
o
o
o
o
o
o
i
i
o
o
o
o
o
o
o
o
o
o
o
o
E
E
o
o
o
o
o
E
E
E
E
E
E
E
E
l
i
i
i
i
i
i
l
a
"}
(50,1,1) = {"
a
E
E
E
E
E
E
E
E
E
E
E
E
E
E
E
E
E
E
E
E
E
E
E
E
E
E
E
E
E
E
E
E
E
E
E
E
E
E
E
E
E
E
E
o
o
o
E
E
o
o
o
o
o
o
o
o
o
o
o
o
o
i
i
o
o
o
o
o
o
o
o
o
o
o
o
E
d
o
o
o
o
o
o
E
E
E
E
E
E
E
l
l
l
k
l
k
l
l
a
"}
(51,1,1) = {"
a
E
E
E
E
E
E
E
E
E
E
E
E
E
E
E
E
E
E
E
E
E
E
E
E
E
E
E
E
E
E
E
E
E
E
E
E
E
E
E
E
E
E
E
o
o
o
o
o
o
o
o
o
o
o
o
o
o
o
o
o
o
i
i
o
o
o
o
o
o
o
o
o
o
o
E
E
T
E
o
o
o
o
o
E
E
E
E
E
E
E
E
E
E
E
E
E
E
E
a
"}
(52,1,1) = {"
a
E
E
E
E
E
E
E
E
E
E
E
E
E
E
E
E
E
E
E
E
E
E
E
E
E
E
E
E
E
E
E
E
E
E
E
E
E
E
E
E
E
E
E
E
o
o
o
o
o
o
o
o
o
o
o
o
o
o
o
o
o
E
E
o
o
o
o
o
o
o
o
o
o
o
d
E
T
E
o
o
o
o
o
E
E
E
E
E
E
E
E
E
E
E
E
E
E
E
a
"}
(53,1,1) = {"
a
E
E
E
E
E
E
E
E
E
E
E
E
E
E
E
E
E
E
E
E
E
E
E
E
E
E
E
E
E
E
E
E
E
E
E
E
E
E
E
E
E
E
E
E
E
o
o
o
o
o
o
o
o
o
o
o
o
o
o
o
o
E
E
o
o
o
o
o
o
o
o
o
o
o
o
E
E
E
o
o
o
o
o
E
E
E
E
E
E
E
E
E
E
E
E
E
E
E
a
"}
(54,1,1) = {"
a
E
E
E
E
E
E
E
E
E
E
E
E
E
E
E
E
E
E
E
E
E
E
E
E
E
E
E
E
E
E
E
E
E
E
E
E
E
E
E
E
E
E
E
E
E
E
E
o
o
o
o
o
o
o
o
o
o
o
o
o
o
E
o
o
o
o
o
o
o
o
o
o
o
o
o
E
E
d
o
o
o
o
o
E
E
E
E
E
E
E
E
E
E
E
E
E
E
E
a
"}
(55,1,1) = {"
a
E
E
E
E
E
E
E
E
E
E
E
E
E
E
E
E
E
E
E
E
E
E
E
E
E
E
E
E
E
E
E
E
E
E
E
E
E
E
E
E
E
E
E
E
E
E
E
E
E
E
o
o
o
E
V
V
V
V
V
V
V
E
o
o
o
o
o
o
o
o
o
o
o
o
o
T
E
d
o
o
o
o
o
o
E
E
E
E
E
E
E
E
E
E
E
E
E
E
a
"}
(56,1,1) = {"
a
E
E
E
E
E
E
E
E
E
E
E
E
E
E
E
E
E
E
E
E
E
E
E
E
E
E
E
E
E
E
E
E
E
E
E
E
E
E
E
E
E
E
E
E
E
E
E
E
E
E
o
o
E
E
V
V
V
V
V
V
V
E
o
o
o
o
o
o
o
o
o
o
o
o
o
E
E
o
o
o
o
o
o
E
E
E
E
E
E
E
E
E
E
E
E
E
E
E
a
"}
(57,1,1) = {"
a
E
E
E
E
E
E
E
E
E
E
E
E
E
E
E
E
E
E
E
E
E
E
E
E
E
E
E
E
E
E
E
E
E
E
E
E
E
E
E
E
E
E
E
E
E
E
E
E
E
E
o
o
E
E
o
o
o
o
o
o
o
o
o
o
o
o
o
o
o
o
o
o
o
o
o
d
E
o
o
o
o
o
E
E
E
E
E
E
E
E
E
E
D
D
E
E
E
E
a
"}
(58,1,1) = {"
a
E
E
E
E
E
E
E
E
E
E
E
E
E
E
E
E
E
E
E
E
E
E
E
E
E
E
E
E
E
E
E
E
E
E
E
E
E
E
E
E
E
E
E
E
E
E
E
E
E
o
o
o
E
E
o
o
o
o
o
o
o
o
o
o
o
o
o
o
o
o
o
o
o
o
E
E
o
o
o
o
o
D
E
D
E
E
E
E
E
E
E
D
D
D
D
E
D
D
a
"}
(59,1,1) = {"
a
E
E
E
E
E
E
E
E
E
E
E
E
E
E
E
E
E
E
E
E
E
E
E
E
E
E
E
E
E
E
E
E
E
E
E
E
E
E
E
E
E
E
E
E
E
E
E
E
E
o
o
E
E
E
V
V
V
V
V
V
E
o
o
o
o
o
o
o
o
o
o
o
o
o
T
E
o
o
o
o
o
D
D
D
D
E
E
E
E
E
D
D
D
D
D
D
D
D
a
"}
(60,1,1) = {"
a
E
E
E
E
E
E
E
E
E
E
E
E
E
E
E
E
E
E
E
E
E
E
E
E
E
E
E
E
E
E
E
E
E
E
E
E
E
E
E
E
E
E
E
E
E
E
E
E
E
o
o
E
E
E
V
V
V
V
o
V
E
o
o
o
o
o
o
V
V
V
V
V
V
V
E
o
o
o
o
o
o
D
D
D
D
D
E
E
E
E
E
D
D
D
D
D
D
D
a
"}
(61,1,1) = {"
a
E
E
E
E
E
E
E
E
E
E
E
E
E
E
E
E
E
E
E
E
E
E
E
E
E
E
E
E
E
E
E
E
E
E
E
E
E
E
E
E
E
E
E
E
E
E
E
E
E
o
o
E
E
E
o
o
o
o
o
o
E
E
o
o
i
i
V
V
V
V
V
V
V
V
E
o
o
o
o
E
D
D
D
D
D
D
D
E
E
E
E
E
E
D
D
D
D
D
a
"}
(62,1,1) = {"
a
E
E
E
E
E
E
E
E
E
E
E
E
E
E
E
E
E
E
E
E
E
E
E
E
E
E
E
E
E
E
E
E
E
E
E
E
E
E
E
E
E
E
E
E
E
E
E
E
E
o
o
E
E
E
o
o
o
o
o
o
o
E
o
o
i
i
o
o
o
o
o
o
o
o
o
o
o
o
E
E
D
D
D
D
a
D
D
D
E
E
E
E
E
D
D
D
D
a
a
"}
(63,1,1) = {"
a
E
E
E
E
E
E
E
E
E
E
E
E
E
E
E
E
E
E
E
E
E
E
E
E
E
E
E
E
E
E
E
E
E
E
E
E
E
E
E
E
E
E
E
E
E
E
E
E
E
o
E
E
E
o
o
o
o
o
o
o
E
E
o
o
i
i
o
o
o
o
o
o
o
o
o
o
o
E
E
E
D
D
D
D
a
a
D
D
D
E
E
E
D
D
D
D
a
a
a
"}
(64,1,1) = {"
a
E
E
E
E
E
E
E
E
E
E
E
E
E
E
E
E
E
E
E
E
E
E
E
E
E
E
E
E
E
E
E
E
E
E
E
E
E
E
E
E
E
E
E
E
E
E
E
E
E
o
E
E
E
o
o
o
o
o
o
o
E
o
o
o
i
i
o
o
o
o
o
o
o
o
o
o
o
o
E
E
D
D
D
D
a
a
D
D
D
D
E
E
D
D
D
D
a
a
a
"}
(65,1,1) = {"
a
E
E
E
E
E
E
E
E
E
E
E
E
E
E
E
E
E
E
E
E
E
E
E
E
E
E
E
E
E
E
E
E
E
E
E
E
E
E
E
E
E
E
E
E
E
E
E
E
E
o
E
E
o
o
o
o
o
o
o
o
E
o
o
o
T
E
o
o
o
o
o
o
o
o
o
o
o
o
E
E
D
D
D
D
a
a
a
D
D
D
D
D
D
D
D
D
a
a
a
"}
(66,1,1) = {"
a
E
E
E
E
E
E
E
E
E
E
E
E
E
E
E
E
E
E
E
E
E
E
E
E
E
E
E
E
E
E
E
E
E
E
E
E
E
E
E
E
E
E
E
E
E
E
E
E
E
o
E
E
o
o
o
o
o
o
o
o
E
o
o
o
E
E
o
o
o
o
o
o
o
o
o
o
o
o
E
E
E
D
D
D
a
a
a
D
D
D
D
D
D
D
D
a
a
a
a
"}
(67,1,1) = {"
a
E
E
E
E
E
E
E
E
E
E
E
E
E
E
E
E
E
E
E
E
E
E
E
E
E
E
E
E
E
E
E
E
E
E
E
E
E
E
E
E
E
E
E
E
E
E
E
E
E
o
E
E
o
o
o
o
o
E
V
V
E
E
o
o
o
d
o
o
o
o
o
o
o
o
o
o
o
o
E
E
E
E
D
D
D
a
a
a
D
D
D
D
D
D
D
a
a
a
a
"}
(68,1,1) = {"
a
E
E
E
E
E
E
E
E
E
E
E
E
E
E
E
E
E
E
E
E
E
E
E
E
E
E
E
E
E
E
E
E
E
E
E
E
E
E
E
E
E
E
E
E
E
E
E
E
E
o
E
E
o
o
o
o
E
E
V
E
E
E
o
o
o
T
o
o
o
o
o
o
o
o
o
o
o
E
E
E
E
E
D
D
D
a
a
a
a
D
D
D
a
a
a
a
a
a
a
"}
(69,1,1) = {"
a
E
E
E
E
E
E
E
E
E
E
E
E
E
E
E
E
E
E
E
E
E
E
E
E
E
E
E
E
E
E
E
E
E
E
E
E
E
E
E
E
E
E
E
E
E
E
E
E
E
o
E
E
o
o
o
o
E
E
o
E
E
E
o
o
o
E
E
o
o
o
o
o
o
o
o
o
E
E
E
E
E
E
D
D
D
D
a
a
a
a
a
a
a
a
a
a
a
a
a
"}
(70,1,1) = {"
a
E
E
E
E
E
E
E
E
E
E
E
E
E
E
E
E
E
E
E
E
E
E
E
E
E
E
E
E
E
E
E
E
E
E
E
E
E
E
E
E
E
E
E
E
E
E
E
E
E
o
E
E
o
o
o
o
E
o
o
E
E
o
o
o
o
E
E
o
o
o
o
o
o
o
E
E
E
E
E
E
E
E
E
D
D
D
D
a
a
a
a
a
a
a
a
a
a
a
a
"}
(71,1,1) = {"
a
E
E
E
E
E
E
E
E
E
E
E
E
E
E
E
E
E
E
E
E
E
E
E
E
E
E
E
E
E
E
E
E
E
E
E
E
E
E
E
E
E
E
E
E
E
E
E
E
E
o
E
E
o
o
o
o
E
E
o
E
o
o
o
o
o
E
E
o
o
o
o
o
o
o
E
E
E
E
E
E
E
E
E
D
D
D
D
D
D
a
a
a
a
a
a
a
a
a
a
"}
(72,1,1) = {"
a
E
E
E
E
E
E
E
E
E
E
E
E
E
E
E
E
E
E
E
E
E
E
E
E
E
E
E
E
E
E
E
E
E
E
E
E
E
E
E
E
E
E
E
E
E
E
E
E
E
E
E
E
E
o
o
o
E
E
o
o
o
o
o
o
o
o
E
o
o
o
o
o
o
o
E
E
E
E
E
E
E
E
E
D
D
D
D
D
D
D
a
a
a
a
a
D
a
a
a
"}
(73,1,1) = {"
a
E
E
E
E
E
E
E
E
E
E
E
E
E
E
E
E
E
E
E
E
E
E
E
E
E
E
E
E
E
E
E
E
E
E
E
E
E
E
E
E
E
E
E
E
E
E
E
E
E
E
E
E
E
o
o
o
o
E
o
o
o
o
o
o
o
o
E
o
o
o
o
o
o
o
o
E
E
E
E
E
E
E
E
E
D
D
D
D
D
D
D
D
D
a
a
D
D
a
a
"}
(74,1,1) = {"
a
E
E
E
E
E
E
E
E
E
E
E
E
E
E
E
E
E
E
E
E
E
E
E
E
E
E
E
E
E
E
E
E
E
E
E
E
E
E
E
E
E
E
E
E
E
E
E
E
E
E
E
E
E
o
o
o
E
E
o
o
o
o
o
o
o
o
E
o
o
o
o
o
o
o
o
E
E
E
E
E
E
E
E
E
E
D
D
D
D
D
D
D
D
D
D
D
D
D
a
"}
(75,1,1) = {"
a
E
E
E
E
E
E
E
E
E
E
E
E
E
E
E
E
E
E
E
E
E
E
E
E
E
E
E
E
E
E
E
E
E
E
E
E
E
E
E
E
E
E
E
E
E
E
E
E
E
E
E
E
E
E
o
o
E
E
V
V
V
V
V
V
V
E
E
o
o
o
o
o
o
o
o
E
E
E
E
E
E
E
E
E
E
E
E
D
D
D
D
D
D
D
D
D
D
D
a
"}
(76,1,1) = {"
a
E
E
E
E
E
E
E
E
E
E
E
E
E
E
E
E
E
E
E
E
E
E
E
E
E
E
E
E
E
E
E
E
E
E
E
E
E
E
E
E
E
E
E
E
E
E
E
E
E
E
E
E
E
E
o
o
o
E
V
V
V
V
V
V
V
E
o
o
o
o
o
o
o
o
o
E
E
E
E
E
E
E
E
E
E
E
E
D
D
D
D
D
D
D
D
D
D
D
a
"}
(77,1,1) = {"
a
E
E
E
E
E
E
E
E
E
E
E
E
E
E
E
E
E
E
E
E
E
E
E
E
E
E
E
E
E
E
E
E
E
E
E
E
E
E
E
E
E
E
E
E
E
E
E
E
E
E
E
E
E
E
E
E
o
E
o
o
o
o
o
o
o
o
o
o
o
o
o
o
o
o
o
o
E
E
E
E
E
E
E
E
E
E
E
E
D
D
D
D
D
D
D
D
D
D
a
"}
(78,1,1) = {"
a
E
E
E
E
E
E
E
E
E
E
E
E
E
E
E
E
E
E
E
E
E
E
E
E
E
E
E
E
E
E
E
E
E
E
E
E
E
E
E
E
E
E
E
E
E
E
E
E
E
E
E
E
E
E
E
E
o
o
o
o
o
o
o
o
o
o
o
o
o
o
o
o
o
o
o
o
E
E
E
E
E
E
E
E
E
E
E
E
D
D
D
D
D
D
D
D
D
D
a
"}
(79,1,1) = {"
a
E
E
E
E
E
E
E
E
E
E
E
E
E
E
E
E
E
E
E
E
E
E
E
E
E
E
E
E
E
E
E
E
E
E
E
E
E
E
E
E
E
E
E
E
E
E
E
E
E
E
E
E
E
E
E
E
E
E
E
E
E
E
E
E
E
o
o
o
o
o
o
o
o
o
o
o
E
E
E
E
E
E
E
E
E
E
E
E
D
D
D
D
D
D
D
D
D
D
a
"}
(80,1,1) = {"
a
E
E
E
E
E
E
E
E
E
E
E
E
E
E
E
E
E
E
E
E
E
E
E
E
E
E
E
E
E
E
E
E
E
E
E
E
E
E
E
E
E
E
E
E
E
E
E
E
E
E
E
E
E
E
E
E
E
E
E
E
E
E
E
E
E
E
E
E
E
E
E
E
E
E
E
E
E
E
E
E
E
E
E
E
E
E
E
E
D
D
D
D
D
D
D
D
D
D
a
"}
(81,1,1) = {"
a
E
E
E
E
E
E
E
E
E
E
E
E
E
E
E
E
E
E
E
E
E
E
E
E
E
E
E
E
E
E
E
E
E
E
E
E
E
E
E
E
E
E
E
E
E
E
E
E
E
E
E
E
E
E
E
E
E
E
E
E
E
E
E
E
E
E
E
E
E
E
E
E
E
E
E
E
E
E
E
E
E
E
E
E
E
E
E
E
E
E
D
D
D
D
D
D
D
D
a
"}
(82,1,1) = {"
a
E
E
E
E
E
E
E
E
E
E
E
E
E
E
E
E
E
E
E
E
E
E
E
E
E
E
E
E
E
E
E
E
E
E
E
E
E
E
E
E
E
E
E
E
E
E
E
E
E
E
E
E
E
E
E
E
E
E
E
E
E
E
E
E
E
E
E
E
E
E
E
E
E
E
E
E
E
E
E
E
E
E
E
E
E
E
E
E
E
E
E
E
D
D
D
D
D
D
a
"}
(83,1,1) = {"
a
E
E
E
E
E
E
E
E
E
E
E
E
E
E
E
E
E
E
E
E
E
E
E
E
E
E
E
E
E
E
E
E
E
E
E
E
E
E
E
E
E
E
E
E
E
E
E
E
E
E
E
E
E
E
E
E
E
E
E
E
E
E
E
E
E
E
E
E
E
E
E
E
E
E
E
E
E
E
E
E
E
E
E
E
E
E
E
E
E
E
E
E
E
D
D
D
D
D
a
"}
(84,1,1) = {"
a
E
E
E
E
E
E
E
E
E
E
E
E
E
E
E
E
E
E
E
E
E
E
E
E
E
E
E
E
E
E
E
E
E
E
E
E
E
E
E
E
E
E
E
E
E
E
E
E
E
E
E
E
E
E
E
E
E
E
E
E
E
E
E
E
E
E
E
E
E
E
E
E
E
E
E
E
E
E
E
E
E
E
E
E
E
E
E
E
E
E
E
E
E
E
D
D
D
D
a
"}
(85,1,1) = {"
a
E
E
E
E
E
E
E
E
E
E
E
E
E
E
E
E
E
E
E
E
E
E
E
E
E
E
E
E
E
E
E
E
E
E
E
E
E
E
E
E
E
E
E
E
E
E
E
E
E
E
E
E
E
E
E
E
E
E
E
E
E
E
E
E
E
E
E
E
E
E
E
E
E
E
E
E
E
E
E
E
E
E
E
E
E
E
E
E
E
E
E
E
E
E
E
D
D
D
a
"}
(86,1,1) = {"
a
E
E
E
E
E
E
E
E
E
E
E
E
E
E
E
E
E
E
E
E
E
E
E
E
E
E
E
E
E
E
E
E
E
E
E
E
E
E
E
E
E
E
E
E
E
E
E
E
E
E
E
E
E
E
E
E
E
E
E
E
E
E
E
E
E
E
E
E
E
E
E
E
E
E
E
E
E
E
E
E
E
E
E
E
E
E
E
E
E
E
E
E
E
E
E
E
E
E
a
"}
(87,1,1) = {"
a
E
E
E
E
E
E
E
E
E
E
E
E
E
E
E
E
E
E
E
E
E
E
E
E
E
E
E
E
E
E
E
E
E
E
E
E
E
E
E
E
E
E
E
E
E
E
E
E
E
E
E
E
E
E
E
E
E
E
E
E
E
E
E
E
E
E
E
E
E
E
E
E
E
E
E
E
E
E
E
E
E
E
E
E
E
E
E
E
E
E
E
E
E
E
E
E
E
E
a
"}
(88,1,1) = {"
a
E
E
E
E
E
E
E
E
E
E
E
E
E
E
E
E
E
E
E
E
E
E
E
E
E
E
E
E
E
E
E
E
E
E
E
E
E
E
E
E
E
E
E
E
E
E
E
E
E
E
E
E
E
E
E
E
E
E
E
E
E
E
E
E
E
E
E
E
E
E
E
E
E
E
E
E
E
E
E
E
E
E
E
E
E
E
E
E
E
E
E
E
E
E
E
E
E
E
a
"}
(89,1,1) = {"
a
E
E
E
E
E
E
E
E
E
E
E
E
E
E
E
E
E
E
E
E
E
E
E
E
E
E
E
E
E
E
E
E
E
E
E
E
E
E
E
E
E
E
E
E
E
E
E
E
E
E
E
E
E
E
E
E
E
E
E
E
E
E
E
E
E
E
E
E
E
E
E
E
E
E
E
E
E
E
E
E
E
E
E
E
E
E
E
E
E
E
E
E
E
E
E
E
E
E
a
"}
(90,1,1) = {"
a
E
E
E
E
E
E
E
E
E
E
E
E
E
E
E
E
E
E
E
E
E
E
E
E
E
E
E
E
E
E
E
E
E
E
E
E
E
E
E
E
E
E
E
E
E
E
E
E
E
E
E
E
E
E
E
E
E
E
E
E
E
E
E
E
E
E
E
E
E
E
E
E
E
E
E
E
E
E
E
E
E
E
E
E
E
E
E
E
E
E
E
E
E
E
E
E
E
E
a
"}
(91,1,1) = {"
a
E
E
E
E
E
E
E
E
E
E
E
E
E
E
E
E
E
E
E
E
E
E
E
E
E
E
E
E
E
E
E
E
E
E
E
E
E
E
E
E
E
E
E
E
E
E
E
E
E
E
E
E
E
E
E
E
E
E
E
E
E
E
E
E
E
E
E
E
E
E
E
E
E
E
E
E
E
E
E
E
E
E
E
E
E
E
E
E
E
E
E
E
E
E
E
E
E
E
a
"}
(92,1,1) = {"
a
E
E
E
E
E
E
E
E
E
E
E
E
E
E
E
E
E
E
E
E
E
E
E
E
E
E
E
E
E
E
E
E
E
E
E
E
E
E
E
E
E
E
E
E
E
E
E
E
E
E
E
E
E
E
E
E
E
E
E
E
E
E
E
E
E
E
E
E
E
E
E
E
E
E
E
E
E
E
E
E
E
E
E
E
E
E
E
E
E
E
E
E
E
E
E
E
E
E
a
"}
(93,1,1) = {"
a
E
E
E
E
E
E
E
E
E
E
E
E
E
E
E
E
E
E
E
E
E
E
E
E
E
E
E
E
E
E
E
E
E
E
E
E
E
E
E
E
E
E
E
E
E
E
E
E
E
E
E
E
E
E
E
E
E
E
E
E
E
E
E
E
E
E
E
E
E
E
E
E
E
E
E
E
E
E
E
E
E
E
E
E
E
E
E
E
E
E
E
E
E
E
E
E
E
E
a
"}
(94,1,1) = {"
a
E
E
E
E
E
E
E
E
E
E
E
E
E
E
E
E
E
E
E
E
E
E
E
E
E
E
E
E
E
E
E
E
E
E
E
E
E
E
E
E
E
E
E
E
E
E
E
E
E
E
E
E
E
E
E
E
E
E
E
E
E
E
E
E
E
E
E
E
E
E
E
E
E
E
E
E
E
E
E
E
E
E
E
E
E
E
E
E
E
E
E
E
E
E
E
E
E
E
a
"}
(95,1,1) = {"
a
E
E
E
E
E
E
E
E
E
E
E
E
E
E
E
E
E
E
E
E
E
E
E
E
E
E
E
E
E
E
E
E
E
E
E
E
E
E
E
E
E
E
E
E
E
E
E
E
E
E
E
E
E
E
E
E
E
E
E
E
E
E
E
E
E
E
E
E
E
E
E
E
E
E
E
E
E
E
E
E
E
E
E
E
E
E
E
E
E
E
E
E
E
E
E
E
E
E
a
"}
(96,1,1) = {"
a
E
E
E
E
E
E
E
E
E
E
E
E
E
E
E
E
E
E
E
E
E
E
E
E
E
E
E
E
E
E
E
E
E
E
E
E
E
E
E
E
E
E
E
E
E
E
E
E
E
E
E
E
E
E
E
E
E
E
E
E
E
E
E
E
E
E
E
E
E
E
E
E
E
E
E
E
E
E
E
E
E
E
E
E
E
E
E
E
E
E
E
E
E
E
E
E
E
E
a
"}
(97,1,1) = {"
a
E
E
E
E
E
E
E
E
E
E
E
E
E
E
E
E
E
E
E
E
E
E
E
E
E
E
E
E
E
E
E
E
E
E
E
E
E
E
E
E
E
E
E
E
E
E
E
E
E
E
E
E
E
E
E
E
E
E
E
E
E
E
E
E
E
E
E
E
E
E
E
E
E
E
E
E
E
E
E
E
E
E
E
E
E
E
E
E
E
E
E
E
E
E
E
E
E
E
a
"}
(98,1,1) = {"
a
E
E
E
E
E
E
E
E
E
E
E
E
E
E
E
E
E
E
E
E
E
E
E
E
E
E
E
E
E
E
E
E
E
E
E
E
E
E
E
E
E
E
E
E
E
E
E
E
E
E
E
E
E
E
E
E
E
E
E
E
E
E
E
E
E
E
E
E
E
E
E
E
E
E
E
E
E
E
E
E
E
E
E
E
E
E
E
E
E
E
E
E
E
E
E
E
E
E
a
"}
(99,1,1) = {"
a
E
E
E
E
E
E
E
E
E
E
E
E
E
E
E
E
E
E
E
E
E
E
E
E
E
E
E
E
E
E
E
E
E
E
E
E
E
E
E
E
E
E
E
E
E
E
E
E
E
E
E
E
E
E
E
E
E
E
E
E
E
E
E
E
E
E
E
E
E
E
E
E
E
E
E
E
E
E
E
E
E
E
E
E
E
E
E
E
E
E
E
E
E
E
E
E
E
E
a
"}
(100,1,1) = {"
a
a
a
a
a
a
a
a
a
a
a
a
a
a
a
a
a
a
a
a
a
a
a
a
a
a
a
a
a
a
a
a
a
a
a
a
a
a
a
a
a
a
a
a
a
a
a
a
a
a
a
a
a
a
a
a
a
a
a
a
a
a
a
a
a
a
a
a
a
a
a
a
a
a
a
a
a
a
a
a
a
a
a
a
a
a
a
a
a
a
a
a
a
a
a
a
a
a
a
a
"}
