"a" = (/turf/closed/mineral/random/asteroid/tospace,/area/space)
"e" = (/turf/open/space/basic,/area/space)

(1,1,1) = {"
eaaaaae
aaaaaaa
aaaaaaa
aaaaaaa
aaaaaaa
aaaaaaa
eaaaaae
"}
