"a" = (/turf/closed/mineral/random/asteroid/tospace/highchance,/area/space)
"W" = (/turf/open/space/basic,/area/space)

(1,1,1) = {"
WaaaaaW
aaaaaaa
aaaaaaa
aaaaaaa
aaaaaaa
aaaaaaa
WaaaaaW
"}
