"a" = (/turf/closed/mineral/random/asteroid/tospace/lowchance,/area/space)
"N" = (/turf/open/space/basic,/area/space)

(1,1,1) = {"
NaaaaaN
aaaaaaa
aaaaaaa
aaaaaaa
aaaaaaa
aaaaaaa
NaaaaaN
"}
