//MAP CONVERTED BY dmm2tgm.py THIS HEADER COMMENT PREVENTS RECONVERSION, DO NOT REMOVE
"a" = (
/turf/open/indestructible/hive,
/area/station/hive/four)
"h" = (
/turf/cordon,
/area/space)
"i" = (
/turf/cordon,
/area/misc/cordon)
"k" = (
/turf/closed/indestructible/hive,
/area/station/hive/one)
"o" = (
/turf/open/indestructible/hive,
/area/station/hive/two)
"t" = (
/obj/structure/hive_exit,
/turf/closed/indestructible/hive,
/area/station/hive/two)
"z" = (
/turf/closed/indestructible/hive,
/area/station/hive/four)
"E" = (
/turf/open/space/basic,
/area/space)
"F" = (
/turf/closed/indestructible/hive,
/area/station/hive/two)
"H" = (
/turf/open/indestructible/hive,
/area/station/hive/one)
"J" = (
/obj/structure/hive_exit,
/turf/closed/indestructible/hive,
/area/station/hive/four)
"K" = (
/obj/structure/hive_exit,
/turf/closed/indestructible/hive,
/area/station/hive/one)
"L" = (
/turf/closed/indestructible/hive,
/area/station/hive/three)
"O" = (
/turf/open/indestructible/hive,
/area/station/hive/three)
"W" = (
/obj/structure/hive_exit,
/turf/closed/indestructible/hive,
/area/station/hive/three)

(1,1,1) = {"
h
h
h
i
i
i
i
i
i
i
i
i
i
i
i
i
i
i
i
i
i
"}
(2,1,1) = {"
h
h
h
i
i
i
i
i
i
i
i
i
i
i
i
i
i
i
i
i
i
"}
(3,1,1) = {"
h
h
E
E
E
E
E
E
E
E
E
E
E
E
E
E
E
E
E
i
i
"}
(4,1,1) = {"
h
h
E
k
k
k
K
k
k
k
E
F
F
F
t
F
F
F
E
i
i
"}
(5,1,1) = {"
h
h
E
k
H
H
H
H
H
k
E
F
o
o
o
o
o
F
E
i
i
"}
(6,1,1) = {"
h
h
E
k
H
H
H
H
H
k
E
F
o
o
o
o
o
F
E
i
i
"}
(7,1,1) = {"
h
h
E
k
H
H
H
H
H
k
E
F
o
o
o
o
o
F
E
i
i
"}
(8,1,1) = {"
h
h
E
k
H
H
H
H
H
k
E
F
o
o
o
o
o
F
E
i
i
"}
(9,1,1) = {"
h
h
E
k
H
H
H
H
H
k
E
F
o
o
o
o
o
F
E
i
i
"}
(10,1,1) = {"
h
h
E
k
k
k
k
k
k
k
E
F
F
F
F
F
F
F
E
i
i
"}
(11,1,1) = {"
h
h
E
E
E
E
E
E
E
E
E
E
E
E
E
E
E
E
E
i
i
"}
(12,1,1) = {"
h
h
E
L
L
L
W
L
L
L
E
z
z
z
J
z
z
z
E
i
i
"}
(13,1,1) = {"
h
h
E
L
O
O
O
O
O
L
E
z
a
a
a
a
a
z
E
i
i
"}
(14,1,1) = {"
h
h
E
L
O
O
O
O
O
L
E
z
a
a
a
a
a
z
E
i
i
"}
(15,1,1) = {"
h
h
E
L
O
O
O
O
O
L
E
z
a
a
a
a
a
z
E
i
i
"}
(16,1,1) = {"
h
h
E
L
O
O
O
O
O
L
E
z
a
a
a
a
a
z
E
i
i
"}
(17,1,1) = {"
h
h
E
L
O
O
O
O
O
L
E
z
a
a
a
a
a
z
E
i
i
"}
(18,1,1) = {"
h
h
E
L
L
L
L
L
L
L
E
z
z
z
z
z
z
z
E
i
i
"}
(19,1,1) = {"
h
h
E
E
E
E
E
E
E
E
E
E
E
E
E
E
E
E
E
h
h
"}
(20,1,1) = {"
h
h
h
h
h
h
h
h
h
h
h
h
h
h
h
h
h
h
h
h
h
"}
(21,1,1) = {"
h
h
h
h
h
h
h
h
h
h
h
h
h
h
h
h
h
h
h
h
h
"}
