//MAP CONVERTED BY dmm2tgm.py THIS HEADER COMMENT PREVENTS RECONVERSION, DO NOT REMOVE
"aj" = (
/obj/structure/barricade/wooden,
/obj/structure/barricade/wooden/crude,
/obj/machinery/door/firedoor,
/turf/open/misc/dirt/station,
/area/station/commons/lounge)
"ak" = (
/obj/structure/flora/bush/jungle/c/style_random,
/turf/open/floor/grass,
/area/station/commons/lounge)
"bF" = (
/obj/machinery/restaurant_portal/restaurant,
/turf/open/floor/grass,
/area/station/commons/lounge)
"cc" = (
/obj/machinery/door/firedoor/border_only{
	dir = 1
	},
/obj/machinery/door/window/left/directional/north{
	name = "Theater Stage"
	},
/obj/machinery/atmospherics/pipe/smart/manifold4w/scrubbers/hidden/layer2,
/obj/machinery/atmospherics/pipe/smart/manifold4w/supply/hidden/layer4,
/turf/open/floor/grass,
/area/station/service/theater)
"ck" = (
/obj/machinery/atmospherics/pipe/smart/manifold4w/scrubbers/hidden/layer2,
/obj/machinery/atmospherics/pipe/smart/manifold4w/supply/hidden/layer4,
/obj/structure/cable,
/obj/machinery/holopad,
/turf/open/floor/grass,
/area/station/commons/lounge)
"cI" = (
/obj/structure/chair/wood{
	dir = 1
	},
/turf/open/floor/grass,
/area/station/commons/lounge)
"dx" = (
/obj/structure/chair/wood{
	dir = 4
	},
/turf/open/floor/grass,
/area/station/commons/lounge)
"eB" = (
/obj/machinery/light/directional/east,
/turf/open/misc/dirt/station,
/area/station/service/theater)
"fg" = (
/obj/machinery/light/floor/has_bulb,
/turf/open/floor/grass,
/area/station/commons/lounge)
"fY" = (
/obj/machinery/atmospherics/pipe/smart/manifold4w/scrubbers/hidden/layer2,
/obj/machinery/atmospherics/pipe/smart/manifold4w/supply/hidden/layer4,
/obj/structure/cable,
/turf/open/water/jungle/station,
/area/station/commons/lounge)
"gM" = (
/obj/structure/flora/bush/fullgrass/style_random,
/obj/structure/flora/bush/flowers_pp/style_random,
/turf/open/floor/grass,
/area/station/commons/lounge)
"hS" = (
/obj/machinery/atmospherics/pipe/smart/manifold4w/scrubbers/hidden/layer2,
/obj/machinery/atmospherics/pipe/smart/manifold4w/supply/hidden/layer4,
/obj/structure/cable,
/obj/effect/landmark/event_spawn,
/turf/open/floor/grass,
/area/station/commons/lounge)
"ir" = (
/obj/structure/flora/bush/large/style_random,
/turf/open/floor/grass,
/area/station/commons/lounge)
"jK" = (
/obj/machinery/atmospherics/pipe/smart/manifold4w/scrubbers/hidden/layer2,
/obj/machinery/atmospherics/pipe/smart/manifold4w/supply/hidden/layer4,
/obj/structure/cable,
/turf/open/floor/grass,
/area/station/commons/lounge)
"ka" = (
/obj/machinery/light/small/directional/north,
/turf/open/water/jungle/station,
/area/station/commons/lounge)
"kw" = (
/turf/open/misc/dirt/station,
/area/station/service/theater)
"kD" = (
/obj/machinery/atmospherics/pipe/smart/manifold4w/supply/hidden/layer4,
/obj/machinery/atmospherics/components/unary/vent_scrubber/on/layer2{
	dir = 8
	},
/turf/open/floor/grass,
/area/station/service/theater)
"mB" = (
/obj/machinery/atmospherics/pipe/smart/manifold4w/scrubbers/hidden/layer2,
/obj/machinery/atmospherics/pipe/smart/manifold4w/supply/hidden/layer4,
/turf/open/floor/grass,
/area/station/service/theater)
"mC" = (
/obj/machinery/firealarm/directional/east,
/obj/machinery/light/directional/east,
/obj/machinery/atmospherics/components/unary/vent_scrubber/on/layer2,
/turf/open/floor/grass,
/area/station/commons/lounge)
"mP" = (
/obj/machinery/atmospherics/pipe/smart/manifold4w/scrubbers/hidden/layer2,
/obj/machinery/atmospherics/pipe/smart/manifold4w/supply/hidden/layer4,
/obj/structure/cable,
/obj/structure/flora/rock/pile/jungle/large/style_random,
/obj/structure/flora/tree/jungle/style_random,
/turf/open/floor/grass,
/area/station/commons/lounge)
"nj" = (
/turf/open/floor/grass,
/area/station/commons/lounge)
"nB" = (
/obj/machinery/vending/cigarette,
/turf/open/floor/grass,
/area/station/commons/lounge)
"nI" = (
/obj/machinery/atmospherics/pipe/smart/manifold4w/scrubbers/hidden/layer2,
/obj/machinery/atmospherics/pipe/smart/manifold4w/supply/hidden/layer4,
/obj/structure/cable,
/mob/living/carbon/human/species/monkey/punpun,
/turf/open/floor/grass,
/area/station/commons/lounge)
"nN" = (
/obj/machinery/atmospherics/pipe/smart/manifold4w/supply/hidden/layer4,
/turf/open/floor/grass,
/area/station/commons/lounge)
"nR" = (
/obj/structure/chair/wood{
	dir = 8
	},
/obj/effect/landmark/start/hangover,
/turf/open/floor/grass,
/area/station/commons/lounge)
"nU" = (
/obj/machinery/camera/autoname/directional/south,
/obj/machinery/airalarm/directional/south,
/obj/structure/disposalpipe/trunk{
	dir = 8
	},
/obj/machinery/disposal/bin,
/obj/machinery/light/small/directional/south,
/turf/open/floor/grass,
/area/station/commons/lounge)
"oa" = (
/obj/machinery/computer/slot_machine,
/obj/machinery/light/directional/east,
/turf/open/floor/grass,
/area/station/commons/lounge)
"op" = (
/obj/machinery/atmospherics/pipe/smart/manifold4w/scrubbers/hidden/layer2,
/turf/open/floor/grass,
/area/station/commons/lounge)
"pg" = (
/obj/structure/flora/bush/fullgrass/style_random,
/obj/structure/flora/bush/leavy/style_random,
/turf/open/floor/grass,
/area/station/commons/lounge)
"po" = (
/obj/machinery/light_switch/directional/west,
/obj/machinery/light/directional/west,
/obj/structure/flora/bush/jungle/b/style_random,
/turf/open/floor/grass,
/area/station/commons/lounge)
"pP" = (
/obj/machinery/atmospherics/components/unary/vent_pump/on/layer4{
	dir = 8
	},
/turf/open/floor/grass,
/area/station/service/theater)
"qi" = (
/obj/structure/chair/wood,
/turf/open/floor/grass,
/area/station/commons/lounge)
"qT" = (
/obj/machinery/door/firedoor,
/obj/machinery/door/airlock/wood{
	name = "Bar"
	},
/turf/open/misc/dirt/station,
/area/station/commons/lounge)
"tT" = (
/obj/structure/barricade/wooden,
/obj/structure/barricade/wooden/crude,
/obj/machinery/door/firedoor,
/turf/open/misc/dirt/jungle,
/area/station/commons/lounge)
"tU" = (
/obj/machinery/atmospherics/pipe/smart/manifold4w/scrubbers/hidden/layer2,
/obj/machinery/atmospherics/pipe/smart/manifold4w/supply/hidden/layer4,
/obj/structure/cable,
/obj/structure/disposalpipe/segment,
/turf/open/floor/grass,
/area/station/commons/lounge)
"uo" = (
/obj/machinery/door/firedoor/border_only{
	dir = 1
	},
/obj/structure/window/reinforced/spawner/directional/north,
/obj/structure/table/wood,
/obj/item/instrument/violin,
/turf/open/floor/grass,
/area/station/service/theater)
"vc" = (
/turf/closed/wall/mineral/wood,
/area/station/service/theater)
"vv" = (
/obj/machinery/door/firedoor,
/obj/machinery/door/airlock/wood{
	name = "Bar"
	},
/turf/open/misc/dirt/jungle,
/area/station/commons/lounge)
"vy" = (
/obj/structure/chair/wood{
	dir = 4
	},
/obj/effect/landmark/start/hangover,
/turf/open/floor/grass,
/area/station/commons/lounge)
"wd" = (
/obj/machinery/door/firedoor/border_only{
	dir = 1
	},
/obj/structure/window/reinforced/spawner/directional/north,
/turf/open/floor/grass,
/area/station/service/theater)
"wF" = (
/obj/structure/flora/bush/fullgrass/style_random,
/obj/structure/flora/bush/grassy/style_random,
/turf/open/floor/grass,
/area/station/commons/lounge)
"wM" = (
/obj/structure/table/wood,
/obj/item/instrument/guitar{
	pixel_x = -7
	},
/obj/item/instrument/eguitar{
	pixel_x = 5
	},
/obj/item/instrument/banjo,
/turf/open/floor/grass,
/area/station/service/theater)
"xk" = (
/obj/structure/disposalpipe/segment{
	dir = 4
	},
/turf/open/floor/grass,
/area/station/commons/lounge)
"xK" = (
/obj/machinery/atmospherics/pipe/smart/manifold4w/scrubbers/hidden/layer2,
/obj/machinery/atmospherics/pipe/smart/manifold4w/supply/hidden/layer4,
/obj/structure/cable,
/obj/structure/disposalpipe/segment{
	dir = 9
	},
/turf/open/floor/grass,
/area/station/commons/lounge)
"yJ" = (
/turf/template_noop,
/area/template_noop)
"zv" = (
/obj/structure/table/wood,
/obj/item/instrument/saxophone,
/obj/item/instrument/trombone,
/turf/open/floor/grass,
/area/station/service/theater)
"AS" = (
/obj/machinery/computer/slot_machine,
/turf/open/floor/grass,
/area/station/commons/lounge)
"Bs" = (
/obj/machinery/atmospherics/pipe/smart/manifold4w/scrubbers/hidden/layer2,
/obj/machinery/atmospherics/pipe/smart/manifold4w/supply/hidden/layer4,
/obj/structure/cable,
/obj/structure/flora/rock/pile/jungle/style_random,
/obj/structure/flora/tree/jungle/small/style_random,
/turf/open/floor/grass,
/area/station/commons/lounge)
"Bu" = (
/obj/machinery/light/directional/west,
/obj/structure/flora/bush/fullgrass/style_random,
/obj/structure/flora/bush/flowers_br/style_random,
/turf/open/floor/grass,
/area/station/commons/lounge)
"BD" = (
/obj/machinery/restaurant_portal/bar,
/turf/open/floor/grass,
/area/station/commons/lounge)
"CE" = (
/obj/structure/flora/rock/pile/style_random,
/turf/open/floor/grass,
/area/station/commons/lounge)
"Dd" = (
/obj/structure/chair/wood{
	dir = 8
	},
/turf/open/floor/grass,
/area/station/service/theater)
"Dg" = (
/obj/machinery/atmospherics/components/unary/vent_scrubber/on/layer2{
	dir = 8
	},
/turf/open/floor/grass,
/area/station/commons/lounge)
"Dv" = (
/turf/open/misc/dirt/station,
/area/station/commons/lounge)
"EB" = (
/obj/effect/spawner/random/entertainment/arcade{
	dir = 8
	},
/turf/open/floor/grass,
/area/station/commons/lounge)
"FS" = (
/obj/structure/table/wood,
/turf/open/floor/grass,
/area/station/commons/lounge)
"HA" = (
/obj/structure/chair/wood{
	dir = 1
	},
/obj/effect/landmark/start/hangover,
/turf/open/floor/grass,
/area/station/commons/lounge)
"HI" = (
/obj/machinery/atmospherics/pipe/smart/manifold4w/scrubbers/hidden/layer2,
/obj/machinery/atmospherics/pipe/smart/manifold4w/supply/hidden/layer4,
/obj/structure/cable,
/obj/structure/disposalpipe/segment{
	dir = 6
	},
/turf/open/floor/grass,
/area/station/commons/lounge)
"Im" = (
/obj/structure/sign/poster/contraband/clown/directional/west,
/obj/structure/table/wood,
/obj/item/instrument/accordion,
/turf/open/floor/grass,
/area/station/service/theater)
"Ir" = (
/obj/machinery/light/directional/east,
/obj/item/radio/intercom/directional/east,
/obj/machinery/atmospherics/components/unary/vent_pump/on/layer4{
	dir = 1
	},
/turf/open/floor/grass,
/area/station/commons/lounge)
"Kc" = (
/obj/machinery/atmospherics/pipe/smart/manifold4w/scrubbers/hidden/layer2,
/obj/machinery/atmospherics/pipe/smart/manifold4w/supply/hidden/layer4,
/turf/open/floor/grass,
/area/station/commons/lounge)
"Ke" = (
/obj/structure/flora/rock/style_random,
/turf/open/floor/grass,
/area/station/commons/lounge)
"Nf" = (
/obj/machinery/camera/directional/south{
	c_tag = "Service - Theater";
	name = "service camera"
	},
/obj/machinery/airalarm/directional/south,
/turf/open/misc/dirt/station,
/area/station/service/theater)
"Ni" = (
/obj/machinery/camera/autoname/directional/north,
/obj/machinery/media/jukebox,
/turf/open/floor/grass,
/area/station/commons/lounge)
"Oz" = (
/obj/structure/chair/wood{
	dir = 8
	},
/turf/open/floor/grass,
/area/station/commons/lounge)
"OG" = (
/obj/machinery/door/firedoor/border_only{
	dir = 1
	},
/obj/structure/window/reinforced/spawner/directional/north,
/turf/open/misc/dirt/station,
/area/station/service/theater)
"OP" = (
/obj/machinery/atmospherics/pipe/smart/manifold4w/scrubbers/hidden/layer2,
/obj/machinery/atmospherics/pipe/smart/manifold4w/supply/hidden/layer4,
/obj/structure/cable,
/obj/structure/disposalpipe/segment{
	dir = 4
	},
/turf/open/floor/grass,
/area/station/commons/lounge)
"PE" = (
/obj/machinery/atmospherics/pipe/smart/manifold4w/scrubbers/hidden/layer2,
/obj/machinery/atmospherics/pipe/smart/manifold4w/supply/hidden/layer4,
/obj/structure/cable,
/obj/structure/barricade/wooden,
/obj/structure/barricade/wooden/crude,
/obj/machinery/door/firedoor,
/turf/open/misc/dirt/station,
/area/station/commons/lounge)
"QK" = (
/obj/machinery/atmospherics/pipe/smart/manifold4w/scrubbers/hidden/layer2,
/obj/machinery/atmospherics/pipe/smart/manifold4w/supply/hidden/layer4,
/turf/open/water/jungle/station,
/area/station/commons/lounge)
"QO" = (
/obj/structure/flora/bush/fullgrass/style_random,
/obj/structure/flora/bush/flowers_yw/style_random,
/turf/open/floor/grass,
/area/station/commons/lounge)
"QW" = (
/obj/machinery/firealarm/directional/west,
/obj/structure/musician/piano,
/obj/machinery/light/directional/west,
/turf/open/floor/grass,
/area/station/service/theater)
"Rc" = (
/obj/item/radio/intercom/directional/south,
/turf/open/misc/dirt/station,
/area/station/service/theater)
"Th" = (
/obj/machinery/light/small/directional/north,
/obj/machinery/barsign/directional/north,
/obj/structure/flora/bush/jungle/a/style_random,
/turf/open/floor/grass,
/area/station/commons/lounge)
"TV" = (
/obj/machinery/atmospherics/components/unary/vent_pump/on/layer4{
	dir = 8
	},
/turf/open/floor/grass,
/area/station/commons/lounge)
"Ub" = (
/turf/closed/wall/mineral/wood,
/area/station/commons/lounge)
"WK" = (
/obj/structure/bonfire/prelit,
/turf/open/misc/dirt/station,
/area/station/commons/lounge)
"XW" = (
/turf/open/water/jungle/station,
/area/station/commons/lounge)
"Yt" = (
/obj/structure/chair/wood,
/obj/effect/landmark/start/hangover,
/turf/open/floor/grass,
/area/station/commons/lounge)
"YM" = (
/obj/machinery/power/apc/auto_name/directional/west,
/obj/structure/cable,
/turf/open/floor/grass,
/area/station/commons/lounge)
"ZB" = (
/obj/structure/flora/rock/pile/jungle/style_random,
/obj/structure/flora/tree/jungle/small/style_random,
/turf/open/floor/grass,
/area/station/commons/lounge)
"ZC" = (
/turf/open/floor/grass,
/area/station/service/theater)

(1,1,1) = {"
Ub
nj
jK
nj
Bu
nR
Oz
nR
po
nj
YM
ir
nj
OP
gM
CE
yJ
"}
(2,1,1) = {"
Ub
nj
jK
Bs
jK
jK
nI
jK
jK
jK
jK
HI
tU
xK
jK
jK
yJ
"}
(3,1,1) = {"
Ub
Th
TV
nj
vy
nj
jK
QO
dx
vy
Dg
xk
AS
AS
oa
EB
yJ
"}
(4,1,1) = {"
Dv
Ni
nj
nj
FS
nj
mP
nj
FS
FS
nj
nU
vc
vc
vc
vc
yJ
"}
(5,1,1) = {"
vv
nj
QO
nj
Oz
nj
hS
fg
nR
Oz
pg
CE
uo
wM
QW
zv
Im
"}
(6,1,1) = {"
tT
nj
nj
WK
Ke
XW
fY
QK
QK
QK
QK
Kc
cc
mB
Dd
ZC
ZC
"}
(7,1,1) = {"
vv
nj
XW
XW
XW
XW
ck
qi
FS
HA
XW
XW
wd
kD
ZC
kw
kw
"}
(8,1,1) = {"
Dv
ka
XW
Yt
FS
cI
jK
wF
nj
nj
ZB
ak
wd
pP
kw
kw
Nf
"}
(9,1,1) = {"
Ub
gM
ir
nj
mC
op
jK
nN
Ir
nj
nj
nj
OG
kw
kw
kw
Rc
"}
(10,1,1) = {"
Ub
bF
nB
BD
Ub
qT
PE
qT
Ub
Yt
FS
cI
OG
kw
eB
kw
kw
"}
(11,1,1) = {"
Ub
aj
aj
aj
Ub
yJ
yJ
yJ
Ub
aj
aj
aj
vc
vc
vc
vc
vc
"}
