//MAP CONVERTED BY dmm2tgm.py THIS HEADER COMMENT PREVENTS RECONVERSION, DO NOT REMOVE
"a" = (
/turf/template_noop,
/area/template_noop)
"b" = (
/turf/open/misc/asteroid/airless,
/area/ruin/space/has_grav)
"d" = (
/turf/closed/wall,
/area/ruin/space/has_grav)
"C" = (
/mob/living/basic/mining/hivelord,
/turf/open/misc/asteroid/airless,
/area/ruin/space/has_grav)
"H" = (
/mob/living/basic/mining/basilisk,
/turf/open/misc/asteroid/airless,
/area/ruin/space/has_grav)
"L" = (
/obj/docking_port/stationary{
	dir = 2;
	dwidth = 15;
	height = 17;
	shuttle_id = "freeminer_asteroid";
	name = "Asteroid Cluster";
	width = 28
	},
/turf/template_noop,
/area/template_noop)
"Q" = (
/turf/closed/mineral/random/high_chance,
/area/ruin/space/has_grav)
"T" = (
/obj/item/gps/computer/beacon,
/turf/open/misc/asteroid/airless,
/area/ruin/space/has_grav)
"Y" = (
/obj/effect/turf_decal/sand/plating,
/turf/open/floor/plating/airless,
/area/ruin/space/has_grav)

(1,1,1) = {"
a
a
a
a
a
a
a
a
a
a
a
a
a
a
a
a
a
a
a
a
a
a
a
a
a
a
a
a
a
a
a
a
a
a
a
a
a
a
a
a
a
a
a
a
a
"}
(2,1,1) = {"
a
a
a
a
a
a
a
a
a
a
a
a
a
a
a
a
a
a
a
a
a
a
Q
Q
a
a
a
a
a
a
a
a
a
a
a
a
a
a
a
a
a
a
a
a
a
"}
(3,1,1) = {"
a
a
a
a
a
a
a
a
a
a
a
a
a
a
a
a
a
a
a
a
a
Q
Q
Q
Q
a
a
a
a
a
a
a
a
a
a
a
a
a
a
a
a
a
a
a
a
"}
(4,1,1) = {"
a
a
a
a
a
a
a
b
b
b
b
a
a
a
a
a
a
a
a
a
a
Q
Q
Q
Q
a
a
a
a
a
a
a
a
a
a
a
a
a
a
a
a
a
a
a
a
"}
(5,1,1) = {"
a
a
a
a
a
a
b
b
b
Q
Q
Q
Q
Q
Q
Q
a
a
a
a
a
Q
Q
Q
a
a
a
a
a
a
a
a
a
a
a
a
a
a
a
a
a
a
a
a
a
"}
(6,1,1) = {"
a
a
a
a
b
b
b
Q
Q
Q
Q
Q
Q
Q
Q
Q
Q
a
a
a
a
a
a
a
a
a
a
a
a
a
a
a
a
a
a
a
a
a
a
a
a
a
a
a
a
"}
(7,1,1) = {"
a
a
a
a
b
Q
Q
Q
Q
Q
Q
Q
Q
Q
Q
Q
Q
Q
Q
a
a
a
a
a
a
Q
Q
a
a
a
a
a
a
a
a
a
a
a
a
a
a
a
a
a
a
"}
(8,1,1) = {"
a
a
a
b
b
b
Q
Q
Q
Q
Q
Q
Q
Q
Q
Q
Q
Q
Q
Q
Q
a
a
a
Q
Q
Q
a
a
a
a
a
a
a
a
a
a
a
a
a
a
a
a
a
a
"}
(9,1,1) = {"
a
a
a
b
Q
b
Q
Q
Q
Q
Q
Q
Q
Q
Q
Q
Q
Q
Q
Q
Q
Q
a
a
Q
Q
Q
a
a
a
a
a
a
a
a
a
a
a
a
a
a
a
a
a
a
"}
(10,1,1) = {"
a
a
b
b
Q
b
b
b
b
b
Q
Q
Q
Q
Q
Q
Q
Q
Q
Q
Q
Q
a
a
a
a
a
a
a
a
a
a
a
a
a
a
a
a
a
a
a
a
a
a
a
"}
(11,1,1) = {"
a
a
b
Q
Q
Q
Q
Q
Q
b
Q
Q
Q
Q
Q
Q
Q
Q
Q
Q
Q
Q
a
a
a
a
a
a
a
a
a
a
a
a
a
a
a
a
a
a
a
a
a
a
a
"}
(12,1,1) = {"
a
a
b
Q
Q
Q
b
b
Q
b
Q
Q
Q
b
Q
Q
Q
Q
Q
Q
Q
Q
Q
Q
a
a
a
a
a
a
a
a
a
a
a
a
a
a
a
a
a
a
a
a
a
"}
(13,1,1) = {"
a
a
b
Q
Q
Q
b
b
b
b
b
b
b
b
b
b
Q
Q
Q
Q
Q
Q
Q
Q
Q
a
a
a
a
a
a
a
a
a
a
a
a
a
a
a
a
a
a
a
a
"}
(14,1,1) = {"
a
a
a
Q
Q
Q
b
b
C
Q
b
Q
b
H
b
b
b
Q
Q
Q
Q
Q
Q
Q
Q
Q
b
a
a
a
a
a
a
a
a
a
a
a
a
a
a
a
a
a
a
"}
(15,1,1) = {"
a
a
a
Q
Q
Q
b
b
Q
Q
b
Q
b
b
b
Q
Q
Q
C
Q
Q
Q
Q
Q
Q
T
b
d
a
a
a
a
a
a
a
a
a
a
a
a
a
a
a
a
a
"}
(16,1,1) = {"
a
a
a
Q
Q
Q
Q
b
Q
b
b
Q
Q
b
b
b
Q
Q
Q
Q
Q
Q
Q
Q
Q
b
b
Y
a
a
a
a
a
a
a
a
a
a
a
a
a
a
a
a
a
"}
(17,1,1) = {"
a
a
a
a
Q
Q
Q
b
b
b
Q
Q
Q
Q
Q
Q
Q
Q
Q
Q
Q
Q
Q
Q
Q
b
b
Y
L
a
a
a
a
a
a
a
a
a
a
a
a
a
a
a
a
"}
(18,1,1) = {"
a
a
a
a
Q
Q
Q
b
b
b
Q
Q
Q
Q
Q
Q
Q
Q
Q
Q
Q
Q
Q
Q
Q
b
b
Y
a
a
a
a
a
a
a
a
a
a
a
a
a
a
a
a
a
"}
(19,1,1) = {"
a
a
a
a
a
Q
Q
Q
b
Q
Q
Q
Q
Q
Q
Q
Q
Q
Q
Q
Q
Q
Q
Q
Q
Q
b
d
a
a
a
a
a
a
a
a
a
a
a
a
a
a
a
a
a
"}
(20,1,1) = {"
a
b
Q
a
a
Q
Q
Q
Q
Q
Q
Q
Q
Q
Q
Q
Q
Q
Q
Q
Q
Q
Q
Q
Q
Q
b
a
a
a
a
a
a
a
a
a
a
a
a
a
a
a
a
a
a
"}
(21,1,1) = {"
Q
Q
Q
a
a
a
Q
Q
Q
Q
Q
Q
Q
Q
Q
Q
Q
Q
Q
Q
Q
Q
Q
Q
a
a
a
a
a
a
a
a
a
a
a
a
a
a
a
a
a
a
a
a
a
"}
(22,1,1) = {"
a
Q
a
a
a
a
a
Q
Q
Q
Q
Q
Q
Q
Q
Q
Q
Q
Q
Q
Q
a
a
a
a
a
a
a
a
a
a
a
a
a
a
a
a
a
a
a
a
a
a
a
a
"}
(23,1,1) = {"
a
a
a
a
a
a
a
a
Q
Q
Q
Q
Q
Q
Q
Q
Q
Q
Q
Q
a
a
a
a
a
a
a
a
a
a
a
a
a
a
a
a
a
a
a
a
a
a
a
a
a
"}
(24,1,1) = {"
a
a
Q
Q
Q
a
a
a
a
a
Q
Q
Q
Q
Q
Q
Q
Q
Q
Q
a
a
a
a
a
a
a
a
a
a
a
a
a
a
a
a
a
a
a
a
a
a
a
a
a
"}
(25,1,1) = {"
a
Q
Q
Q
Q
Q
a
a
a
a
a
Q
Q
Q
Q
Q
Q
Q
Q
a
a
a
a
a
a
a
a
a
a
a
a
a
a
a
a
a
a
a
a
a
a
a
a
a
a
"}
(26,1,1) = {"
a
Q
Q
Q
Q
Q
a
a
a
a
a
a
a
Q
Q
Q
Q
Q
a
a
a
a
a
a
a
a
a
a
a
a
a
a
a
a
a
a
a
a
a
a
a
a
a
a
a
"}
(27,1,1) = {"
a
Q
Q
Q
Q
Q
a
a
a
a
a
a
a
a
a
a
a
a
a
a
a
a
a
a
a
a
a
a
a
a
a
a
a
a
a
a
a
a
a
a
a
a
a
a
a
"}
(28,1,1) = {"
a
Q
Q
Q
Q
Q
Q
a
a
a
a
a
a
a
a
a
a
a
a
a
a
a
a
a
a
a
a
a
a
a
a
a
a
a
a
a
a
a
a
a
a
a
a
a
a
"}
(29,1,1) = {"
a
a
Q
Q
Q
Q
a
a
a
a
a
a
a
a
a
a
a
a
a
a
Q
Q
a
a
a
a
a
a
a
a
a
a
a
a
a
a
a
a
a
a
a
a
a
a
a
"}
(30,1,1) = {"
a
a
a
a
a
a
a
a
a
Q
Q
Q
Q
a
a
a
a
a
Q
Q
Q
Q
a
a
a
a
a
a
a
a
a
a
a
a
a
a
a
a
a
a
a
a
a
a
a
"}
(31,1,1) = {"
a
a
a
a
a
a
a
Q
Q
Q
Q
Q
Q
Q
Q
a
a
a
Q
Q
Q
Q
a
a
a
a
a
a
a
a
a
a
a
a
a
a
a
a
a
a
a
a
a
a
a
"}
(32,1,1) = {"
a
a
a
Q
Q
a
Q
Q
Q
Q
Q
Q
Q
Q
Q
Q
a
Q
Q
Q
Q
Q
a
a
a
a
a
a
a
a
a
a
a
a
a
a
a
a
a
a
a
a
Q
a
a
"}
(33,1,1) = {"
a
a
Q
Q
Q
a
Q
Q
Q
Q
Q
Q
Q
Q
Q
Q
a
Q
Q
Q
Q
a
a
a
a
a
a
a
a
a
a
a
a
a
a
a
a
a
a
a
a
Q
Q
Q
a
"}
(34,1,1) = {"
a
Q
Q
Q
a
a
Q
Q
Q
Q
Q
Q
Q
Q
Q
Q
a
a
a
a
a
a
a
a
Q
Q
Q
Q
a
a
a
a
a
a
a
a
a
a
a
a
Q
Q
Q
Q
Q
"}
(35,1,1) = {"
a
Q
Q
Q
a
a
Q
Q
Q
Q
Q
Q
Q
Q
Q
Q
a
a
a
a
a
a
a
Q
Q
Q
Q
Q
Q
a
a
a
a
a
a
a
a
a
a
a
Q
Q
Q
Q
Q
"}
(36,1,1) = {"
a
Q
Q
a
a
a
a
Q
Q
Q
Q
Q
Q
Q
Q
a
a
a
a
a
a
a
Q
Q
Q
Q
Q
Q
Q
a
a
a
a
a
a
a
a
a
a
a
a
Q
Q
Q
a
"}
(37,1,1) = {"
a
a
a
a
a
a
a
a
Q
Q
Q
Q
Q
Q
Q
a
a
a
a
a
a
Q
Q
Q
Q
Q
Q
Q
Q
a
a
a
a
a
a
Q
Q
Q
Q
a
a
a
Q
a
a
"}
(38,1,1) = {"
a
a
a
a
Q
Q
a
a
a
a
Q
Q
Q
Q
a
a
a
a
a
a
a
Q
Q
Q
Q
Q
Q
Q
Q
a
a
a
a
a
Q
Q
Q
Q
Q
Q
a
a
a
a
a
"}
(39,1,1) = {"
a
a
a
Q
Q
Q
Q
a
a
a
a
a
a
a
a
a
a
a
a
a
Q
Q
Q
Q
Q
Q
Q
Q
Q
a
a
a
a
a
Q
Q
Q
Q
Q
Q
a
a
a
a
a
"}
(40,1,1) = {"
a
a
Q
Q
Q
Q
Q
Q
a
a
a
a
Q
Q
Q
a
a
a
a
a
Q
Q
Q
Q
Q
Q
Q
Q
a
a
a
a
a
Q
Q
Q
Q
Q
Q
Q
a
a
a
a
a
"}
(41,1,1) = {"
a
a
Q
Q
Q
Q
Q
Q
a
a
a
Q
Q
Q
Q
Q
a
a
a
a
Q
Q
Q
Q
Q
Q
Q
a
a
a
a
a
a
Q
Q
Q
Q
Q
Q
Q
a
a
a
a
a
"}
(42,1,1) = {"
a
a
Q
Q
Q
Q
Q
Q
a
a
a
Q
Q
Q
Q
Q
a
a
a
a
Q
Q
Q
Q
Q
Q
a
a
a
a
a
a
a
Q
Q
Q
Q
Q
Q
Q
a
a
a
a
a
"}
(43,1,1) = {"
a
a
Q
Q
Q
Q
Q
a
a
a
a
a
Q
Q
Q
Q
a
a
a
a
Q
Q
Q
Q
a
a
a
a
a
a
a
a
a
a
a
Q
Q
Q
Q
a
a
a
a
a
a
"}
(44,1,1) = {"
a
a
a
Q
Q
a
a
a
a
a
a
a
Q
Q
a
a
a
a
a
a
a
a
a
a
a
a
a
a
a
a
a
a
a
a
a
a
a
a
a
a
a
a
a
a
a
"}
(45,1,1) = {"
a
a
a
a
a
a
a
a
a
a
a
a
a
a
a
a
a
a
a
a
a
a
a
a
a
a
a
a
a
a
a
a
a
a
a
a
a
a
a
a
a
a
a
a
a
"}
