//MAP CONVERTED BY dmm2tgm.py THIS HEADER COMMENT PREVENTS RECONVERSION, DO NOT REMOVE
"a" = (
/obj/machinery/light/directional/north,
/obj/structure/chair/comfy/shuttle,
/obj/machinery/vending/wallmed/directional/west,
/turf/open/floor/mineral/titanium/white,
/area/shuttle/arrival)
"d" = (
/obj/structure/fans/tiny/invisible,
/obj/machinery/door/airlock/shuttle{
	name = "Arrival Shuttle Airlock"
	},
/turf/open/floor/mineral/titanium/white,
/area/shuttle/arrival)
"h" = (
/turf/closed/wall/mineral/titanium,
/area/shuttle/arrival)
"m" = (
/obj/machinery/door/window/left/directional/west,
/turf/open/floor/mineral/titanium/blue,
/area/shuttle/arrival)
"s" = (
/obj/machinery/light/directional/north,
/obj/item/radio/intercom/directional/north,
/obj/structure/chair/comfy/shuttle{
	dir = 4
	},
/obj/structure/window/reinforced/spawner/directional/west,
/turf/open/floor/mineral/titanium/blue,
/area/shuttle/arrival)
"t" = (
/obj/structure/chair/comfy/shuttle,
/turf/open/floor/mineral/titanium/white,
/area/shuttle/arrival)
"u" = (
/turf/template_noop,
/area/template_noop)
"w" = (
/obj/item/clothing/suit/hazardvest{
	desc = "A high-visibility lifejacket complete with whistle and slot for oxygen tanks.";
	name = "emergency lifejacket"
	},
/obj/item/clothing/suit/hazardvest{
	desc = "A high-visibility lifejacket complete with whistle and slot for oxygen tanks.";
	name = "emergency lifejacket"
	},
/obj/item/tank/internals/emergency_oxygen{
	pixel_x = 3
	},
/obj/item/tank/internals/emergency_oxygen{
	pixel_x = 3
	},
/obj/item/clothing/mask/breath{
	pixel_x = -3;
	pixel_y = -3
	},
/obj/item/clothing/mask/breath{
	pixel_x = -3;
	pixel_y = -3
	},
/obj/item/clothing/head/utility/hardhat/orange{
	name = "protective hat";
	pixel_y = 9
	},
/obj/item/clothing/head/utility/hardhat/orange{
	name = "protective hat";
	pixel_y = 9
	},
/obj/structure/closet/crate/internals,
/obj/effect/turf_decal/delivery,
/turf/open/floor/mineral/plastitanium,
/area/shuttle/arrival)
"x" = (
/obj/structure/chair/comfy/shuttle{
	dir = 1
	},
/turf/open/floor/mineral/titanium/white,
/area/shuttle/arrival)
"E" = (
/obj/structure/sign/warning/fire,
/turf/closed/wall/mineral/titanium,
/area/shuttle/arrival)
"F" = (
/obj/effect/spawner/structure/window/reinforced/shuttle,
/obj/structure/fans/tiny/invisible,
/obj/docking_port/mobile/arrivals,
/turf/open/floor/plating,
/area/shuttle/arrival)
"Q" = (
/obj/effect/spawner/structure/window/reinforced/shuttle,
/obj/structure/fans/tiny/invisible,
/turf/open/floor/plating,
/area/shuttle/arrival)
"T" = (
/obj/machinery/light/directional/south,
/obj/structure/chair/comfy/shuttle{
	dir = 4
	},
/obj/structure/window/reinforced/spawner/directional/west,
/turf/open/floor/mineral/titanium/blue,
/area/shuttle/arrival)
"U" = (
/obj/machinery/status_display/evac/directional/north,
/turf/open/floor/mineral/titanium/white,
/area/shuttle/arrival)
"W" = (
/obj/machinery/light/directional/south,
/obj/structure/chair/comfy/shuttle{
	dir = 1
	},
/obj/machinery/vending/wallmed/directional/south,
/turf/open/floor/mineral/titanium/white,
/area/shuttle/arrival)
"Z" = (
/turf/open/floor/mineral/titanium/white,
/area/shuttle/arrival)

(1,1,1) = {"
u
h
E
h
u
"}
(2,1,1) = {"
h
h
w
h
h
"}
(3,1,1) = {"
h
a
Z
W
h
"}
(4,1,1) = {"
Q
t
Z
x
Q
"}
(5,1,1) = {"
h
U
Z
Z
d
"}
(6,1,1) = {"
h
s
m
T
h
"}
(7,1,1) = {"
h
Q
F
Q
h
"}
