//MAP CONVERTED BY dmm2tgm.py THIS HEADER COMMENT PREVENTS RECONVERSION, DO NOT REMOVE
"a" = (
/obj/structure/chair/sofa/bench/left{
	dir = 8
	},
/obj/structure/window/spawner/directional/south,
/turf/open/floor/iron,
/area/shuttle/arrival)
"b" = (
/turf/closed/wall,
/area/shuttle/arrival)
"d" = (
/obj/effect/spawner/structure/window/reinforced,
/obj/docking_port/mobile/arrivals{
	dir = 2
	},
/turf/open/floor/plating,
/area/shuttle/arrival)
"g" = (
/obj/machinery/light/directional/north,
/turf/open/floor/mineral/titanium,
/area/shuttle/arrival)
"j" = (
/obj/machinery/door/airlock/public/glass{
	name = "Centcom - Steelbeam Subway"
	},
/turf/open/floor/iron,
/area/shuttle/arrival)
"k" = (
/obj/structure/chair/sofa/bench,
/turf/open/floor/iron,
/area/shuttle/arrival)
"l" = (
/turf/template_noop,
/area/template_noop)
"m" = (
/obj/structure/chair/sofa/bench/left,
/obj/machinery/light/directional/north,
/turf/open/floor/iron,
/area/shuttle/arrival)
"r" = (
/obj/structure/window/reinforced/spawner/directional/east,
/turf/open/floor/iron,
/area/shuttle/arrival)
"t" = (
/obj/machinery/light/directional/west,
/turf/open/floor/iron,
/area/shuttle/arrival)
"w" = (
/obj/structure/window/spawner/directional/north,
/obj/structure/chair/sofa/bench/left{
	dir = 4
	},
/turf/open/floor/iron,
/area/shuttle/arrival)
"x" = (
/turf/open/floor/mineral/titanium,
/area/shuttle/arrival)
"z" = (
/obj/structure/chair/sofa/bench/right{
	dir = 8
	},
/obj/structure/window/spawner/directional/north,
/turf/open/floor/iron,
/area/shuttle/arrival)
"B" = (
/obj/structure/chair/comfy/shuttle,
/turf/open/floor/mineral/titanium,
/area/shuttle/arrival)
"E" = (
/obj/structure/chair/sofa/bench/right{
	dir = 4
	},
/obj/structure/window/spawner/directional/south,
/turf/open/floor/iron,
/area/shuttle/arrival)
"G" = (
/obj/structure/window/reinforced/spawner/directional/west,
/turf/open/floor/iron,
/area/shuttle/arrival)
"H" = (
/obj/effect/spawner/structure/window/reinforced,
/turf/open/floor/plating,
/area/shuttle/arrival)
"I" = (
/turf/open/floor/iron,
/area/shuttle/arrival)
"J" = (
/obj/structure/chair/sofa/bench/left{
	dir = 4
	},
/obj/structure/window/spawner/directional/north,
/turf/open/floor/iron,
/area/shuttle/arrival)
"P" = (
/obj/structure/chair/sofa/bench/right,
/obj/machinery/light/directional/north,
/turf/open/floor/iron,
/area/shuttle/arrival)
"R" = (
/obj/machinery/light/directional/east,
/turf/open/floor/iron,
/area/shuttle/arrival)
"T" = (
/obj/machinery/door/airlock/public/glass{
	name = "Centcom - Steelbeam Subway"
	},
/turf/open/floor/mineral/titanium,
/area/shuttle/arrival)
"U" = (
/obj/structure/chair/sofa/bench{
	dir = 8
	},
/turf/open/floor/iron,
/area/shuttle/arrival)
"V" = (
/obj/structure/chair/sofa/bench{
	dir = 4
	},
/turf/open/floor/iron,
/area/shuttle/arrival)
"Z" = (
/obj/machinery/light/directional/south,
/turf/open/floor/iron,
/area/shuttle/arrival)

(1,1,1) = {"
b
b
j
H
H
H
H
H
j
b
b
l
b
b
j
H
H
H
H
j
b
b
b
l
"}
(2,1,1) = {"
b
P
I
J
V
V
V
E
I
t
b
l
b
t
I
w
V
V
E
I
b
x
H
H
"}
(3,1,1) = {"
b
k
I
I
I
I
I
I
I
I
b
G
b
I
I
I
I
I
I
Z
b
g
B
H
"}
(4,1,1) = {"
b
k
I
I
I
I
I
I
I
I
j
I
j
I
I
I
I
I
I
I
T
x
x
d
"}
(5,1,1) = {"
b
k
I
I
I
I
I
I
I
I
b
r
b
I
I
I
I
I
I
Z
b
g
B
H
"}
(6,1,1) = {"
b
m
I
z
U
U
U
a
I
R
b
l
b
R
I
z
U
U
a
I
b
x
H
H
"}
(7,1,1) = {"
b
b
j
H
H
H
H
H
j
b
b
l
b
b
j
H
H
H
H
j
b
b
b
l
"}
