//MAP CONVERTED BY dmm2tgm.py THIS HEADER COMMENT PREVENTS RECONVERSION, DO NOT REMOVE
"a" = (
/obj/machinery/door/poddoor/shutters{
	id = "cargoloadL"
	},
/obj/structure/fans/tiny,
/obj/effect/turf_decal/stripes/corner,
/turf/open/floor/iron,
/area/shuttle/supply)
"e" = (
/obj/machinery/door/poddoor/shutters{
	id = "cargoloadR"
	},
/obj/structure/fans/tiny,
/obj/effect/turf_decal/stripes/corner{
	dir = 1
	},
/turf/open/floor/iron,
/area/shuttle/supply)
"j" = (
/obj/machinery/door/poddoor/shutters{
	id = "cargoloadR"
	},
/obj/structure/fans/tiny,
/obj/effect/turf_decal/stripes/corner{
	dir = 8
	},
/turf/open/floor/iron,
/area/shuttle/supply)
"m" = (
/obj/machinery/light/directional/west,
/obj/effect/turf_decal/stripes/line{
	dir = 8
	},
/turf/open/floor/iron,
/area/shuttle/supply)
"o" = (
/obj/effect/turf_decal/stripes/corner,
/turf/open/floor/iron,
/area/shuttle/supply)
"p" = (
/obj/effect/turf_decal/stripes/corner{
	dir = 4
	},
/turf/open/floor/iron,
/area/shuttle/supply)
"q" = (
/obj/effect/turf_decal/stripes/corner{
	dir = 8
	},
/turf/open/floor/iron,
/area/shuttle/supply)
"s" = (
/obj/machinery/power/shuttle_engine/propulsion,
/turf/open/floor/plating/airless,
/area/shuttle/supply)
"u" = (
/obj/effect/turf_decal/stripes/line{
	dir = 9
	},
/turf/open/floor/iron,
/area/shuttle/supply)
"w" = (
/turf/open/floor/iron,
/area/shuttle/supply)
"B" = (
/obj/machinery/door/poddoor/shutters{
	id = "cargoloadL"
	},
/obj/structure/fans/tiny,
/obj/effect/turf_decal/stripes/corner,
/obj/docking_port/mobile/supply{
	dir = 4
	},
/turf/open/floor/iron,
/area/shuttle/supply)
"C" = (
/obj/effect/turf_decal/stripes/corner{
	dir = 1
	},
/turf/open/floor/iron,
/area/shuttle/supply)
"D" = (
/obj/effect/turf_decal/stripes/line{
	dir = 8
	},
/turf/open/floor/iron,
/area/shuttle/supply)
"E" = (
/obj/machinery/light/directional/west,
/obj/effect/turf_decal/stripes/line{
	dir = 10
	},
/turf/open/floor/iron,
/area/shuttle/supply)
"G" = (
/turf/template_noop,
/area/template_noop)
"I" = (
/obj/effect/turf_decal/stripes/line{
	dir = 5
	},
/turf/open/floor/iron,
/area/shuttle/supply)
"J" = (
/turf/closed/wall/mineral/titanium,
/area/shuttle/supply)
"K" = (
/obj/effect/turf_decal/stripes/line{
	dir = 4
	},
/turf/open/floor/iron,
/area/shuttle/supply)
"L" = (
/obj/machinery/button/door/directional/west{
	id = "cargoloadR";
	name = "Loading Doors";
	pixel_y = 9;
	pixel_x = 8
	},
/turf/closed/wall/mineral/titanium,
/area/shuttle/supply)
"M" = (
/obj/machinery/light/directional/east,
/obj/effect/turf_decal/stripes/line{
	dir = 6
	},
/turf/open/floor/iron,
/area/shuttle/supply)
"Q" = (
/obj/machinery/button/door/directional/west{
	id = "cargoloadL";
	name = "Loading Doors";
	pixel_y = 9;
	pixel_x = -8
	},
/turf/closed/wall/mineral/titanium,
/area/shuttle/supply)
"R" = (
/obj/machinery/light/directional/east,
/obj/effect/turf_decal/stripes/line{
	dir = 4
	},
/turf/open/floor/iron,
/area/shuttle/supply)
"U" = (
/obj/machinery/door/poddoor/shutters{
	id = "cargoloadL"
	},
/obj/structure/fans/tiny,
/obj/effect/turf_decal/stripes/corner{
	dir = 4
	},
/turf/open/floor/iron,
/area/shuttle/supply)
"X" = (
/obj/machinery/power/shuttle_engine/heater,
/obj/structure/window/reinforced/spawner/directional/north,
/turf/open/floor/plating/airless,
/area/shuttle/supply)

(1,1,1) = {"
G
J
J
J
J
U
B
Q
J
J
U
a
J
J
G
"}
(2,1,1) = {"
J
J
u
m
D
C
q
D
m
D
C
q
E
J
J
"}
(3,1,1) = {"
J
J
C
w
w
w
w
w
w
w
w
w
q
X
s
"}
(4,1,1) = {"
J
J
w
w
w
w
w
w
w
w
w
w
w
X
s
"}
(5,1,1) = {"
J
J
w
w
w
w
w
w
w
w
w
w
w
X
s
"}
(6,1,1) = {"
J
J
p
w
w
w
w
w
w
w
w
w
o
X
s
"}
(7,1,1) = {"
J
J
I
R
K
p
o
K
R
K
w
o
M
J
J
"}
(8,1,1) = {"
G
J
J
J
J
e
j
L
J
J
e
j
J
J
G
"}
