//MAP CONVERTED BY dmm2tgm.py THIS HEADER COMMENT PREVENTS RECONVERSION, DO NOT REMOVE
"a" = (
/obj/effect/turf_decal/delivery,
/turf/open/floor/iron/smooth_large,
/area/shuttle/supply)
"b" = (
/obj/effect/turf_decal/stripes/line{
	dir = 10
	},
/obj/machinery/power/shuttle_engine/propulsion/left,
/turf/open/floor/plating/airless,
/area/shuttle/supply)
"c" = (
/obj/effect/turf_decal/delivery,
/obj/machinery/light/directional/west,
/turf/open/floor/iron/smooth_large,
/area/shuttle/supply)
"e" = (
/obj/machinery/conveyor{
	dir = 4;
	id = "QMLoad2"
	},
/obj/machinery/door/poddoor{
	id = "QMLoaddoor2";
	name = "Supply Dock Loading Door";
	auto_dir_align = 0;
	dir = 4
	},
/obj/structure/fans/tiny,
/obj/effect/turf_decal/stripes/line,
/obj/effect/turf_decal/stripes/line{
	dir = 1
	},
/turf/open/floor/plating,
/area/shuttle/supply)
"f" = (
/obj/structure/marker_beacon/olive{
	pixel_x = 5;
	pixel_y = 5
	},
/turf/closed/wall/mineral/titanium,
/area/shuttle/supply)
"g" = (
/obj/machinery/conveyor{
	dir = 4;
	id = "QMLoad2"
	},
/obj/effect/turf_decal/stripes/line,
/obj/effect/turf_decal/stripes/line{
	dir = 1
	},
/turf/open/floor/plating,
/area/shuttle/supply)
"h" = (
/obj/machinery/computer/terminal/craterstation/cargo_helm,
/obj/effect/turf_decal/bot_white,
/obj/machinery/button/door/directional/east{
	id = "crater_cargo_windows";
	name = "Window Controls"
	},
/turf/open/floor/iron/dark/smooth_large,
/area/shuttle/supply)
"i" = (
/obj/structure/marker_beacon/burgundy{
	pixel_x = -6;
	pixel_y = 7
	},
/turf/closed/wall/mineral/titanium,
/area/shuttle/supply)
"j" = (
/obj/structure/fans/tiny,
/obj/machinery/door/airlock/external/glass{
	name = "Cargo Shuttle"
	},
/obj/effect/mapping_helpers/airlock/access/all/supply/general,
/turf/open/floor/plating,
/area/shuttle/supply)
"k" = (
/obj/machinery/door/airlock/command/glass{
	dir = 4;
	name = "Cockpit"
	},
/turf/open/floor/iron/dark/smooth_half,
/area/shuttle/supply)
"l" = (
/obj/effect/turf_decal/stripes/end{
	dir = 8
	},
/turf/open/floor/plating,
/area/shuttle/supply)
"n" = (
/turf/closed/wall/mineral/titanium/nodiagonal,
/area/shuttle/supply)
"o" = (
/turf/open/floor/iron/dark/smooth_edge{
	dir = 8
	},
/area/shuttle/supply)
"q" = (
/turf/open/floor/iron/dark/smooth_edge{
	dir = 1
	},
/area/shuttle/supply)
"s" = (
/turf/template_noop,
/area/template_noop)
"t" = (
/turf/closed/wall/mineral/titanium,
/area/shuttle/supply)
"u" = (
/turf/open/floor/iron/dark/smooth_half{
	dir = 1
	},
/area/shuttle/supply)
"v" = (
/obj/machinery/light/directional/north,
/obj/effect/turf_decal/delivery,
/turf/open/floor/iron/smooth_large,
/area/shuttle/supply)
"w" = (
/obj/structure/fluff/metalpole/end{
	pixel_y = -32
	},
/turf/closed/wall/mineral/plastitanium/nodiagonal,
/area/shuttle/supply)
"x" = (
/obj/machinery/power/shuttle_engine/propulsion,
/obj/effect/turf_decal/stripes/line,
/turf/open/floor/plating/airless,
/area/shuttle/supply)
"y" = (
/obj/machinery/conveyor_switch/oneway{
	id = "QMLoad2";
	name = "Unloading Conveyor"
	},
/turf/open/floor/iron/dark/smooth_half,
/area/shuttle/supply)
"A" = (
/obj/effect/spawner/structure/window/reinforced/shuttle,
/obj/machinery/door/poddoor/shutters/preopen{
	id = "crater_cargo_windows";
	dir = 1;
	set_dir_on_move = 0
	},
/turf/open/floor/plating,
/area/shuttle/supply)
"D" = (
/obj/effect/decal/cleanable/dirt,
/obj/effect/turf_decal/caution/white{
	dir = 8
	},
/turf/open/floor/iron/dark/smooth_edge,
/area/shuttle/supply)
"E" = (
/obj/structure/window/reinforced/plasma/spawner/directional/north,
/obj/machinery/power/shuttle_engine/heater,
/obj/effect/turf_decal/stripes/line{
	dir = 1
	},
/obj/effect/turf_decal/stripes/line{
	dir = 8
	},
/turf/open/floor/plating/airless,
/area/shuttle/supply)
"F" = (
/obj/structure/window/reinforced/plasma/spawner/directional/north,
/obj/machinery/power/shuttle_engine/heater,
/obj/effect/turf_decal/stripes/line{
	dir = 1
	},
/turf/open/floor/plating/airless,
/area/shuttle/supply)
"G" = (
/obj/machinery/conveyor{
	dir = 8;
	id = "QMLoad"
	},
/obj/machinery/door/poddoor{
	id = "QMLoaddoor";
	name = "Supply Dock Loading Door";
	dir = 4;
	auto_dir_align = 0
	},
/obj/structure/fans/tiny,
/obj/effect/turf_decal/stripes/line,
/obj/effect/turf_decal/stripes/line{
	dir = 1
	},
/turf/open/floor/plating,
/area/shuttle/supply)
"H" = (
/obj/effect/turf_decal/stripes/line{
	dir = 10
	},
/obj/machinery/power/shuttle_engine/propulsion/left{
	pixel_x = 0;
	pixel_y = 7
	},
/turf/open/floor/plating/airless,
/area/shuttle/supply)
"I" = (
/obj/machinery/button/door/directional/east{
	id = "QMLoaddoor2";
	name = "Loading Doors";
	pixel_y = 8
	},
/obj/machinery/button/door/directional/east{
	id = "QMLoaddoor";
	name = "Loading Doors";
	pixel_y = -8
	},
/obj/effect/decal/cleanable/dirt,
/turf/open/floor/iron/dark/smooth_half{
	dir = 1
	},
/area/shuttle/supply)
"J" = (
/obj/structure/window/reinforced/plasma/spawner/directional/north,
/obj/machinery/power/shuttle_engine/heater,
/obj/effect/turf_decal/stripes/line{
	dir = 1
	},
/obj/effect/turf_decal/stripes/line{
	dir = 4
	},
/turf/open/floor/plating/airless,
/area/shuttle/supply)
"L" = (
/obj/structure/sign/warning/no_smoking/circle/directional/west,
/turf/open/floor/iron/dark/smooth_half{
	dir = 1
	},
/area/shuttle/supply)
"M" = (
/obj/docking_port/mobile/supply,
/obj/structure/fans/tiny,
/obj/machinery/door/airlock/external/glass{
	name = "Cargo Shuttle"
	},
/obj/effect/mapping_helpers/airlock/access/all/supply/general,
/turf/open/floor/plating,
/area/shuttle/supply)
"N" = (
/obj/effect/spawner/structure/window/reinforced/shuttle,
/obj/machinery/door/poddoor/shutters/preopen{
	id = "crater_cargo_windows";
	dir = 8;
	set_dir_on_move = 0
	},
/turf/open/floor/plating,
/area/shuttle/supply)
"P" = (
/obj/machinery/conveyor_switch/oneway{
	dir = 8;
	id = "QMLoad";
	name = "Loading Conveyor"
	},
/obj/machinery/light/directional/east,
/turf/open/floor/iron/dark/smooth_half,
/area/shuttle/supply)
"R" = (
/obj/machinery/conveyor{
	dir = 8;
	id = "QMLoad"
	},
/obj/effect/turf_decal/stripes/line,
/obj/effect/turf_decal/stripes/line{
	dir = 1
	},
/turf/open/floor/plating,
/area/shuttle/supply)
"S" = (
/obj/effect/turf_decal/stripes/line{
	dir = 6
	},
/obj/machinery/power/shuttle_engine/propulsion/right,
/turf/open/floor/plating/airless,
/area/shuttle/supply)
"T" = (
/obj/machinery/power/shuttle_engine/heater{
	pixel_x = 0;
	pixel_y = 7
	},
/obj/effect/turf_decal/stripes/line{
	dir = 8
	},
/turf/open/floor/plating/airless,
/area/shuttle/supply)
"U" = (
/obj/structure/chair/office/light{
	dir = 1
	},
/turf/open/floor/iron/dark/smooth_half,
/area/shuttle/supply)
"V" = (
/turf/open/floor/iron/dark/smooth_half,
/area/shuttle/supply)
"W" = (
/obj/effect/decal/cleanable/dirt,
/obj/effect/turf_decal/caution/white{
	dir = 8
	},
/turf/open/floor/iron/dark/smooth_edge{
	dir = 1
	},
/area/shuttle/supply)
"X" = (
/obj/structure/table/reinforced/titaniumglass,
/obj/machinery/button/door/directional/east{
	id = "QMLoaddoor2";
	name = "Loading Doors";
	pixel_y = 8
	},
/obj/machinery/button/door/directional/east{
	id = "QMLoaddoor";
	name = "Loading Doors";
	pixel_y = -8
	},
/obj/machinery/light/small/directional/south,
/turf/open/floor/iron/dark/smooth_large,
/area/shuttle/supply)

(1,1,1) = {"
i
N
N
n
n
T
H
s
s
s
s
s
"}
(2,1,1) = {"
A
h
U
X
n
n
n
n
N
n
w
s
"}
(3,1,1) = {"
n
n
k
n
t
a
c
a
a
a
E
b
"}
(4,1,1) = {"
n
a
q
L
o
u
o
u
o
u
F
x
"}
(5,1,1) = {"
n
v
V
l
V
a
V
l
V
a
F
x
"}
(6,1,1) = {"
f
n
y
g
W
I
D
R
P
a
J
S
"}
(7,1,1) = {"
s
t
n
e
j
n
M
G
n
n
w
s
"}
