//MAP CONVERTED BY dmm2tgm.py THIS HEADER COMMENT PREVENTS RECONVERSION, DO NOT REMOVE
"a" = (
/obj/machinery/door/poddoor/shutters{
	id = "cargoloadL"
	},
/obj/structure/fans/tiny,
/obj/effect/turf_decal/stripes/corner,
/turf/open/floor/iron,
/area/shuttle/supply)
"b" = (
/obj/machinery/light/directional/north,
/turf/open/floor/iron,
/area/shuttle/supply)
"d" = (
/obj/structure/fans/tiny,
/obj/effect/turf_decal/stripes/corner{
	dir = 4
	},
/obj/machinery/door/poddoor/shutters{
	id = "cargoloadL"
	},
/turf/open/floor/iron,
/area/shuttle/supply)
"e" = (
/obj/machinery/door/poddoor/shutters{
	id = "cargoloadR"
	},
/obj/structure/fans/tiny,
/obj/effect/turf_decal/stripes/corner{
	dir = 1
	},
/turf/open/floor/iron,
/area/shuttle/supply)
"i" = (
/obj/structure/fans/tiny,
/obj/machinery/door/poddoor/shutters{
	id = "cargoloadR"
	},
/obj/effect/turf_decal/stripes/corner{
	dir = 8
	},
/turf/open/floor/iron,
/area/shuttle/supply)
"j" = (
/obj/machinery/door/poddoor/shutters{
	id = "cargoloadR"
	},
/obj/structure/fans/tiny,
/obj/effect/turf_decal/stripes/corner{
	dir = 8
	},
/turf/open/floor/iron,
/area/shuttle/supply)
"m" = (
/obj/machinery/light/directional/west,
/obj/effect/turf_decal/stripes/line{
	dir = 8
	},
/turf/open/floor/iron,
/area/shuttle/supply)
"o" = (
/obj/effect/turf_decal/stripes/corner,
/turf/open/floor/iron,
/area/shuttle/supply)
"p" = (
/obj/effect/turf_decal/stripes/corner{
	dir = 4
	},
/turf/open/floor/iron,
/area/shuttle/supply)
"q" = (
/obj/effect/turf_decal/stripes/corner{
	dir = 8
	},
/turf/open/floor/iron,
/area/shuttle/supply)
"s" = (
/obj/machinery/power/shuttle_engine/propulsion,
/turf/open/floor/plating/airless,
/area/shuttle/supply)
"u" = (
/obj/effect/turf_decal/stripes/line{
	dir = 9
	},
/turf/open/floor/iron,
/area/shuttle/supply)
"w" = (
/turf/open/floor/iron,
/area/shuttle/supply)
"x" = (
/obj/effect/turf_decal/stripes/line{
	dir = 10
	},
/turf/open/floor/iron,
/area/shuttle/supply)
"B" = (
/obj/effect/turf_decal/stripes/line{
	dir = 6
	},
/turf/open/floor/iron,
/area/shuttle/supply)
"C" = (
/obj/effect/turf_decal/stripes/corner{
	dir = 1
	},
/turf/open/floor/iron,
/area/shuttle/supply)
"D" = (
/obj/effect/turf_decal/stripes/line{
	dir = 8
	},
/turf/open/floor/iron,
/area/shuttle/supply)
"E" = (
/obj/machinery/light/directional/west,
/turf/open/floor/iron,
/area/shuttle/supply)
"G" = (
/turf/template_noop,
/area/template_noop)
"H" = (
/obj/docking_port/mobile/supply{
	dir = 4
	},
/turf/closed/wall/mineral/titanium,
/area/shuttle/supply)
"I" = (
/obj/effect/turf_decal/stripes/line{
	dir = 5
	},
/turf/open/floor/iron,
/area/shuttle/supply)
"J" = (
/turf/closed/wall/mineral/titanium,
/area/shuttle/supply)
"K" = (
/obj/effect/turf_decal/stripes/line{
	dir = 4
	},
/turf/open/floor/iron,
/area/shuttle/supply)
"L" = (
/obj/structure/fans/tiny,
/obj/machinery/door/poddoor/shutters{
	id = "cargoloadR"
	},
/obj/effect/turf_decal/stripes/corner{
	dir = 1
	},
/turf/open/floor/iron,
/area/shuttle/supply)
"M" = (
/obj/machinery/light/directional/east,
/turf/open/floor/iron,
/area/shuttle/supply)
"N" = (
/obj/effect/turf_decal/stripes/line{
	dir = 8
	},
/obj/machinery/light/directional/west,
/turf/open/floor/iron,
/area/shuttle/supply)
"Q" = (
/obj/machinery/button/door/directional/west{
	id = "cargoloadL";
	name = "Loading Doors";
	pixel_y = 9;
	pixel_x = -8
	},
/turf/closed/wall/mineral/titanium,
/area/shuttle/supply)
"R" = (
/obj/effect/turf_decal/stripes/line{
	dir = 4
	},
/obj/machinery/light/directional/east,
/turf/open/floor/iron,
/area/shuttle/supply)
"T" = (
/obj/structure/fans/tiny,
/obj/effect/turf_decal/stripes/corner,
/obj/machinery/door/poddoor/shutters{
	id = "cargoloadL"
	},
/turf/open/floor/iron,
/area/shuttle/supply)
"U" = (
/obj/machinery/door/poddoor/shutters{
	id = "cargoloadL"
	},
/obj/structure/fans/tiny,
/obj/effect/turf_decal/stripes/corner{
	dir = 4
	},
/turf/open/floor/iron,
/area/shuttle/supply)
"X" = (
/obj/machinery/power/shuttle_engine/heater,
/obj/structure/window/reinforced/spawner/directional/north,
/turf/open/floor/plating/airless,
/area/shuttle/supply)

(1,1,1) = {"
G
G
G
G
G
G
G
G
G
G
H
J
J
J
d
T
J
J
J
J
J
J
J
J
U
a
Q
J
G
G
G
G
G
G
"}
(2,1,1) = {"
G
G
G
G
G
G
G
J
J
J
J
u
N
D
C
q
D
N
D
D
D
D
m
D
C
q
x
J
J
J
J
J
J
G
"}
(3,1,1) = {"
G
G
G
G
G
J
J
J
w
E
q
C
w
w
w
w
w
w
w
w
w
w
w
w
w
w
q
C
E
w
E
w
J
J
"}
(4,1,1) = {"
G
G
G
G
J
J
w
w
w
w
w
w
w
w
w
w
w
w
w
w
w
w
w
w
w
w
w
w
w
w
w
w
X
s
"}
(5,1,1) = {"
G
G
G
G
J
b
w
w
w
w
w
w
w
w
w
w
w
w
w
w
w
w
w
w
w
w
w
w
w
w
w
w
X
s
"}
(6,1,1) = {"
G
G
G
J
J
w
w
w
w
w
w
w
w
w
w
w
w
w
w
w
w
w
w
w
w
w
w
w
w
w
w
w
X
s
"}
(7,1,1) = {"
G
G
G
J
w
w
w
w
w
w
w
w
w
w
w
w
w
w
w
w
w
w
w
w
w
w
w
w
w
w
w
w
X
s
"}
(8,1,1) = {"
G
G
G
J
b
w
w
w
w
w
w
w
w
w
w
w
w
w
w
w
w
w
w
w
w
w
w
w
M
w
M
w
J
J
"}
(9,1,1) = {"
G
G
J
J
w
w
w
w
w
w
w
w
w
w
w
w
w
w
w
w
w
w
w
w
w
w
w
J
J
J
J
J
J
G
"}
(10,1,1) = {"
G
G
G
J
b
w
w
w
w
w
w
w
w
w
w
w
w
w
w
w
w
w
w
w
w
w
w
w
E
w
E
w
J
J
"}
(11,1,1) = {"
G
G
G
J
w
w
w
w
w
w
w
w
w
w
w
w
w
w
w
w
w
w
w
w
w
w
w
w
w
w
w
w
X
s
"}
(12,1,1) = {"
G
G
G
J
J
w
w
w
w
w
w
w
w
w
w
w
w
w
w
w
w
w
w
w
w
w
w
w
w
w
w
w
X
s
"}
(13,1,1) = {"
G
G
G
G
J
b
w
w
w
w
w
w
w
w
w
w
w
w
w
w
w
w
w
w
w
w
w
w
w
w
w
w
X
s
"}
(14,1,1) = {"
G
G
G
G
J
J
w
w
w
w
w
w
w
w
w
w
w
w
w
w
w
w
w
w
w
w
w
w
w
w
w
w
X
s
"}
(15,1,1) = {"
G
G
G
G
G
J
J
J
w
M
o
p
w
w
w
w
w
w
w
w
w
w
w
w
w
w
o
p
M
w
M
w
J
J
"}
(16,1,1) = {"
G
G
G
G
G
G
G
J
J
J
J
I
K
K
p
o
K
R
K
K
K
K
R
K
w
o
B
J
J
J
J
J
J
G
"}
(17,1,1) = {"
G
G
G
G
G
G
G
G
G
G
J
J
J
J
L
i
J
J
J
J
J
J
J
J
e
j
J
J
G
G
G
G
G
G
"}
