//MAP CONVERTED BY dmm2tgm.py THIS HEADER COMMENT PREVENTS RECONVERSION, DO NOT REMOVE
"as" = (
/obj/machinery/computer/emergency_shuttle{
	dir = 1
	},
/turf/open/floor/mineral/titanium,
/area/shuttle/escape)
"bo" = (
/obj/effect/abstract/fire/big_fire,
/obj/structure/chair/comfy/shuttle,
/obj/structure/window/reinforced/spawner/directional/north,
/turf/open/floor/mineral/titanium,
/area/shuttle/escape)
"bT" = (
/obj/effect/gibspawner/human,
/turf/open/floor/mineral/titanium,
/area/shuttle/escape)
"cI" = (
/obj/effect/decal/cleanable/blood,
/obj/effect/decal/cleanable/glass,
/turf/open/floor/mineral/titanium,
/area/shuttle/escape)
"dg" = (
/obj/structure/lattice,
/turf/template_noop,
/area/shuttle/escape)
"dp" = (
/obj/effect/abstract/fire/big_fire,
/turf/open/floor/mineral/plastitanium/red,
/area/shuttle/escape/brig)
"dJ" = (
/obj/structure/window/reinforced/spawner/directional/south,
/turf/open/floor/mineral/titanium,
/area/shuttle/escape)
"dT" = (
/obj/effect/decal/cleanable/glass,
/obj/structure/window/reinforced/spawner/directional/west,
/turf/open/floor/mineral/titanium,
/area/shuttle/escape)
"eg" = (
/obj/structure/window/reinforced/spawner/directional/east,
/turf/open/floor/mineral/titanium,
/area/shuttle/escape)
"em" = (
/obj/effect/decal/cleanable/blood/gibs/torso,
/turf/open/floor/plating,
/area/template_noop)
"ex" = (
/obj/structure/chair/comfy/shuttle,
/obj/structure/window/reinforced/spawner/directional/north,
/turf/open/floor/mineral/titanium,
/area/shuttle/escape)
"eB" = (
/obj/structure/chair/comfy/shuttle{
	dir = 4
	},
/turf/open/floor/mineral/plastitanium/red,
/area/shuttle/escape/brig)
"fd" = (
/obj/effect/abstract/fire/big_fire,
/obj/structure/chair/comfy/shuttle,
/turf/open/floor/mineral/titanium,
/area/shuttle/escape)
"fA" = (
/obj/structure/lattice,
/obj/structure/window/reinforced/spawner/directional/north,
/turf/template_noop,
/area/shuttle/escape)
"gk" = (
/obj/docking_port/mobile/emergency,
/turf/open/floor/plating,
/area/template_noop)
"gD" = (
/obj/effect/mob_spawn/corpse/human/assistant,
/turf/open/floor/plating,
/area/template_noop)
"gY" = (
/obj/structure/chair/comfy/shuttle{
	dir = 4
	},
/obj/effect/mob_spawn/corpse/human/nanotrasensoldier,
/turf/open/floor/mineral/plastitanium/red,
/area/shuttle/escape/brig)
"hj" = (
/obj/structure/window/reinforced/spawner/directional/south,
/obj/structure/window/reinforced/spawner/directional/east,
/obj/effect/mob_spawn/corpse/human/nanotrasensoldier,
/turf/open/floor/mineral/plastitanium/red,
/area/shuttle/escape/brig)
"hV" = (
/obj/effect/mob_spawn/corpse/human/assistant,
/obj/effect/decal/cleanable/blood,
/obj/structure/chair/comfy/shuttle,
/obj/structure/window/reinforced/spawner/directional/north,
/turf/open/floor/mineral/titanium,
/area/shuttle/escape)
"kE" = (
/obj/structure/window/reinforced/spawner/directional/south,
/obj/effect/decal/cleanable/blood,
/turf/open/floor/mineral/plastitanium/red,
/area/shuttle/escape/brig)
"lR" = (
/turf/open/floor/mineral/titanium,
/area/shuttle/escape)
"mc" = (
/obj/effect/mob_spawn/corpse/human/nanotrasensoldier,
/turf/open/floor/mineral/plastitanium/red,
/area/shuttle/escape/brig)
"ms" = (
/obj/effect/decal/cleanable/glass,
/obj/structure/chair/comfy/shuttle{
	dir = 8
	},
/obj/effect/decal/cleanable/blood,
/turf/open/floor/mineral/plastitanium/red,
/area/shuttle/escape/brig)
"nM" = (
/obj/structure/chair/comfy/shuttle{
	dir = 4
	},
/obj/effect/gibspawner/human,
/turf/open/floor/mineral/plastitanium/red,
/area/shuttle/escape/brig)
"nQ" = (
/obj/effect/decal/cleanable/blood,
/obj/machinery/door/window/left/directional/north,
/turf/open/floor/mineral/titanium,
/area/shuttle/escape)
"ol" = (
/obj/machinery/power/shuttle_engine/huge{
	dir = 1
	},
/turf/open/floor/plating/airless,
/area/shuttle/escape)
"oz" = (
/obj/effect/abstract/fire/big_fire,
/turf/open/floor/mineral/titanium,
/area/shuttle/escape)
"oR" = (
/obj/structure/chair/comfy/shuttle,
/turf/open/floor/mineral/titanium,
/area/shuttle/escape)
"pF" = (
/obj/structure/window/reinforced/spawner/directional/south,
/obj/structure/window/reinforced/spawner/directional/west,
/obj/effect/mob_spawn/corpse/human/nanotrasensoldier,
/turf/open/floor/mineral/plastitanium/red,
/area/shuttle/escape/brig)
"qI" = (
/obj/effect/abstract/fire/big_fire,
/turf/open/openspace,
/area/template_noop)
"ss" = (
/obj/effect/decal/cleanable/glass,
/obj/machinery/suit_storage_unit/standard_unit,
/turf/open/floor/mineral/titanium,
/area/shuttle/escape)
"sz" = (
/obj/effect/mob_spawn/corpse/human/assistant,
/obj/structure/chair/comfy/shuttle,
/turf/open/floor/mineral/titanium,
/area/shuttle/escape)
"ue" = (
/obj/effect/mob_spawn/corpse/human/assistant,
/obj/structure/window/reinforced/spawner/directional/west,
/obj/machinery/suit_storage_unit/standard_unit,
/turf/open/floor/mineral/titanium,
/area/shuttle/escape)
"uF" = (
/obj/structure/window/reinforced/spawner/directional/south,
/obj/effect/mob_spawn/corpse/human/nanotrasensoldier,
/turf/open/floor/mineral/plastitanium/red,
/area/shuttle/escape/brig)
"vd" = (
/obj/effect/decal/cleanable/blood/gibs/body,
/turf/open/openspace,
/area/template_noop)
"wQ" = (
/obj/effect/mob_spawn/corpse/human/bridgeofficer,
/obj/effect/decal/cleanable/blood,
/obj/effect/decal/cleanable/glass,
/obj/structure/window/reinforced/spawner/directional/north,
/obj/structure/window/reinforced/spawner/directional/west,
/turf/open/floor/mineral/titanium,
/area/shuttle/escape)
"xp" = (
/obj/effect/decal/cleanable/blood/gibs/torso,
/turf/open/openspace,
/area/template_noop)
"xL" = (
/obj/effect/decal/cleanable/blood,
/turf/open/floor/plating,
/area/template_noop)
"xY" = (
/obj/effect/decal/cleanable/blood,
/turf/open/floor/mineral/plastitanium/red,
/area/shuttle/escape/brig)
"ym" = (
/obj/machinery/power/shuttle_engine/large{
	dir = 1
	},
/turf/open/floor/plating/airless,
/area/shuttle/escape)
"yw" = (
/obj/machinery/power/shuttle_engine/heater{
	dir = 1
	},
/obj/structure/window/reinforced/spawner/directional/south,
/obj/structure/window/reinforced/spawner/directional/east,
/turf/open/floor/plating/airless,
/area/shuttle/escape/brig)
"yE" = (
/obj/structure/chair/comfy/shuttle,
/obj/effect/decal/cleanable/glass,
/obj/structure/window/reinforced/spawner/directional/north,
/turf/open/floor/mineral/titanium,
/area/shuttle/escape)
"yQ" = (
/obj/effect/mob_spawn/corpse/human/assistant,
/obj/machinery/suit_storage_unit/standard_unit,
/turf/open/floor/mineral/titanium,
/area/shuttle/escape)
"zj" = (
/obj/effect/mob_spawn/corpse/human/assistant,
/turf/open/floor/mineral/titanium,
/area/shuttle/escape)
"zq" = (
/obj/effect/decal/cleanable/blood/gibs/torso,
/turf/template_noop,
/area/template_noop)
"AJ" = (
/obj/effect/mob_spawn/corpse/human/assistant,
/obj/effect/decal/cleanable/blood,
/obj/effect/decal/cleanable/glass,
/turf/open/floor/mineral/titanium,
/area/shuttle/escape)
"CC" = (
/obj/machinery/power/shuttle_engine/heater{
	dir = 1
	},
/obj/structure/window/reinforced/spawner/directional/south,
/turf/open/floor/plating/airless,
/area/shuttle/escape/brig)
"CH" = (
/obj/effect/mob_spawn/corpse/human/bridgeofficer,
/obj/structure/chair/comfy/shuttle,
/obj/structure/window/reinforced/spawner/directional/east,
/turf/open/floor/mineral/titanium,
/area/shuttle/escape)
"CO" = (
/obj/machinery/power/shuttle_engine/heater{
	dir = 1
	},
/obj/structure/window/reinforced/spawner/directional/south,
/turf/open/floor/plating/airless,
/area/shuttle/escape)
"DG" = (
/obj/effect/gibspawner/human,
/turf/open/floor/plating,
/area/template_noop)
"Ff" = (
/obj/structure/chair/comfy/shuttle,
/obj/effect/decal/cleanable/glass,
/turf/open/floor/mineral/titanium,
/area/shuttle/escape)
"Fi" = (
/obj/effect/gibspawner/human,
/turf/template_noop,
/area/template_noop)
"Fq" = (
/obj/effect/decal/cleanable/blood,
/obj/machinery/suit_storage_unit/standard_unit,
/turf/open/floor/mineral/titanium,
/area/shuttle/escape)
"FF" = (
/obj/effect/mob_spawn/corpse/human/assistant,
/obj/effect/abstract/fire/big_fire,
/obj/machinery/suit_storage_unit/standard_unit,
/turf/open/floor/mineral/titanium,
/area/shuttle/escape)
"Hp" = (
/obj/effect/decal/cleanable/blood,
/obj/effect/decal/cleanable/glass,
/obj/structure/window/reinforced/spawner/directional/east,
/turf/open/floor/mineral/titanium,
/area/shuttle/escape)
"Hs" = (
/obj/structure/chair/comfy/shuttle{
	dir = 8
	},
/obj/effect/mob_spawn/corpse/human/nanotrasensoldier,
/turf/open/floor/mineral/plastitanium/red,
/area/shuttle/escape/brig)
"HT" = (
/obj/machinery/suit_storage_unit/standard_unit,
/turf/open/floor/mineral/titanium,
/area/shuttle/escape)
"Ij" = (
/obj/effect/mob_spawn/corpse/human/assistant,
/obj/effect/decal/cleanable/glass,
/turf/open/floor/mineral/titanium,
/area/shuttle/escape)
"II" = (
/obj/machinery/door/airlock/public/glass{
	name = "Emergency Shuttle Brig"
	},
/obj/effect/mapping_helpers/airlock/access/all/security/general,
/obj/structure/fans/tiny,
/turf/open/floor/mineral/plastitanium/red,
/area/shuttle/escape/brig)
"IS" = (
/obj/effect/decal/cleanable/blood,
/obj/effect/decal/cleanable/blood,
/turf/open/floor/mineral/plastitanium/red,
/area/shuttle/escape/brig)
"Ji" = (
/turf/template_noop,
/area/shuttle/escape)
"KD" = (
/obj/effect/mob_spawn/corpse/human/assistant,
/turf/open/openspace,
/area/template_noop)
"KO" = (
/obj/effect/abstract/fire/big_fire,
/obj/structure/window/reinforced/spawner/directional/east,
/turf/open/floor/mineral/titanium,
/area/shuttle/escape)
"KS" = (
/obj/structure/chair/comfy/shuttle,
/obj/structure/window/reinforced/spawner/directional/north,
/obj/effect/decal/cleanable/glass,
/turf/open/floor/mineral/titanium,
/area/shuttle/escape)
"LI" = (
/turf/open/floor/plating,
/area/template_noop)
"LK" = (
/turf/open/floor/plating/airless,
/area/shuttle/escape)
"Mg" = (
/turf/closed/wall/mineral/titanium,
/area/shuttle/escape)
"Mj" = (
/obj/effect/abstract/fire/big_fire,
/turf/open/openspace,
/area/shuttle/escape)
"Mw" = (
/obj/effect/abstract/fire/big_fire,
/turf/template_noop,
/area/template_noop)
"MD" = (
/obj/effect/decal/cleanable/glass,
/turf/open/floor/mineral/titanium,
/area/shuttle/escape)
"No" = (
/obj/structure/window/reinforced/spawner/directional/east,
/obj/machinery/suit_storage_unit/standard_unit,
/turf/open/floor/mineral/titanium,
/area/shuttle/escape)
"NM" = (
/obj/structure/lattice,
/turf/template_noop,
/area/template_noop)
"Oq" = (
/obj/effect/decal/cleanable/blood,
/obj/effect/gibspawner/human,
/turf/template_noop,
/area/template_noop)
"Oy" = (
/obj/effect/decal/cleanable/blood,
/turf/open/openspace,
/area/template_noop)
"OV" = (
/turf/template_noop,
/area/template_noop)
"Pc" = (
/obj/effect/mob_spawn/corpse/human/assistant,
/turf/template_noop,
/area/template_noop)
"Ps" = (
/obj/effect/decal/cleanable/blood,
/turf/open/floor/mineral/titanium,
/area/shuttle/escape)
"Pw" = (
/obj/effect/mob_spawn/corpse/human/assistant,
/obj/effect/decal/cleanable/blood,
/turf/open/floor/mineral/titanium,
/area/shuttle/escape)
"PT" = (
/obj/structure/fans/tiny,
/obj/machinery/door/window/left/directional/north,
/turf/open/floor/mineral/titanium,
/area/shuttle/escape)
"Qp" = (
/obj/effect/mob_spawn/corpse/human/assistant,
/obj/effect/decal/cleanable/blood,
/turf/template_noop,
/area/template_noop)
"Rt" = (
/obj/effect/decal/cleanable/blood,
/turf/template_noop,
/area/template_noop)
"RI" = (
/obj/effect/decal/cleanable/glass,
/obj/effect/gibspawner/human,
/turf/open/floor/mineral/plastitanium/red,
/area/shuttle/escape/brig)
"RL" = (
/obj/structure/chair/comfy/shuttle{
	dir = 8
	},
/obj/effect/decal/cleanable/blood,
/turf/open/floor/mineral/plastitanium/red,
/area/shuttle/escape/brig)
"Th" = (
/turf/open/openspace,
/area/template_noop)
"WF" = (
/obj/effect/decal/cleanable/blood,
/obj/structure/fans/tiny,
/turf/open/floor/mineral/titanium,
/area/shuttle/escape)
"WN" = (
/obj/effect/abstract/fire/big_fire,
/turf/open/floor/plating,
/area/template_noop)
"XF" = (
/obj/effect/abstract/fire/big_fire,
/obj/structure/lattice,
/turf/open/openspace,
/area/template_noop)
"XQ" = (
/obj/effect/decal/cleanable/glass,
/obj/structure/window/reinforced/spawner/directional/east,
/obj/structure/window/reinforced/spawner/directional/north,
/turf/open/floor/mineral/titanium,
/area/shuttle/escape)
"XR" = (
/obj/structure/lattice,
/turf/open/openspace,
/area/template_noop)
"XX" = (
/obj/machinery/power/shuttle_engine/heater{
	dir = 1
	},
/obj/structure/window/reinforced/spawner/directional/south,
/obj/structure/window/reinforced/spawner/directional/west,
/turf/open/floor/plating/airless,
/area/shuttle/escape/brig)
"Yy" = (
/obj/effect/decal/cleanable/blood/gibs/body,
/turf/template_noop,
/area/template_noop)

(1,1,1) = {"
OV
OV
OV
OV
OV
OV
OV
OV
OV
OV
OV
OV
OV
OV
OV
OV
OV
OV
OV
OV
OV
OV
OV
OV
OV
OV
OV
Rt
OV
Mw
OV
OV
OV
OV
"}
(2,1,1) = {"
OV
OV
OV
OV
OV
OV
OV
Mg
Mg
Mg
Mg
Mg
Mg
LI
gk
Mg
OV
OV
OV
Pc
OV
DG
LI
OV
OV
Qp
XR
zq
OV
OV
OV
Pc
OV
OV
"}
(3,1,1) = {"
OV
OV
OV
OV
OV
OV
OV
LK
LK
CO
FF
bT
oz
lR
dg
dg
Mg
Mg
OV
OV
OV
OV
Mw
Rt
LI
XR
XR
XR
Mw
OV
OV
OV
OV
Mw
"}
(4,1,1) = {"
OV
OV
OV
OV
OV
OV
OV
ym
LK
CO
ss
lR
OV
dg
OV
OV
LI
LI
Mw
OV
LI
LI
OV
OV
Th
Th
vd
LI
Th
Th
Oy
OV
OV
OV
"}
(5,1,1) = {"
OV
OV
OV
OV
OV
OV
OV
Mg
Mg
Mg
HT
oR
MD
oR
zj
OV
LI
LI
DG
LI
gD
LI
OV
Th
KD
WN
LI
DG
LI
LI
Th
qI
Rt
OV
"}
(6,1,1) = {"
OV
OV
OV
OV
OV
OV
OV
OV
Mg
No
KO
lR
zj
oz
lR
zj
MD
Mg
LI
LI
LI
OV
Th
Th
OV
OV
OV
OV
OV
KD
qI
LI
LI
gD
"}
(7,1,1) = {"
OV
OV
OV
Mg
Mg
Mg
Mg
Mg
Mg
zj
lR
ex
lR
ex
lR
ex
lR
Mg
OV
dg
Mg
Mg
Mg
Mg
Mg
OV
OV
Th
Oy
OV
OV
OV
LI
LI
"}
(8,1,1) = {"
OV
OV
Mg
Mg
Mg
nM
gY
eB
kE
lR
Ij
ex
oz
ex
dg
OV
OV
eg
Hp
Fq
Mg
ss
HT
HT
HT
Pc
LI
XR
XR
XR
Mw
Rt
LI
LI
"}
(9,1,1) = {"
OV
OV
LK
LK
LK
XX
IS
dp
hj
MD
lR
ex
lR
ex
bT
Ff
wQ
fd
dJ
dg
Mg
OV
OV
OV
OV
Fi
LI
LI
XR
Yy
OV
Fi
OV
Rt
"}
(10,1,1) = {"
OV
OV
LK
LK
LK
CC
mc
RI
II
lR
WF
nQ
lR
zj
MD
Ps
PT
lR
as
Mg
dg
dg
lR
Pw
cI
OV
MD
Mg
OV
gD
xL
LI
Pc
OV
"}
(11,1,1) = {"
OV
OV
ol
LK
LK
yw
dp
xY
pF
zj
bT
KS
zj
hV
lR
bo
XQ
CH
Mg
Mg
ss
OV
OV
LI
LI
OV
OV
OV
OV
LI
OV
OV
OV
OV
"}
(12,1,1) = {"
OV
OV
Mg
Mg
Mg
Hs
ms
RL
uF
lR
oz
yE
lR
ex
lR
oz
Ji
Ji
Mg
HT
OV
LI
LI
Pw
LI
OV
Mg
LI
LI
LI
Pc
OV
Mw
OV
"}
(13,1,1) = {"
OV
OV
OV
Mg
Mg
Mg
Mg
Mg
Mg
AJ
lR
fA
LI
dg
LI
oR
MD
Mg
Mg
OV
OV
dg
Mg
OV
Mg
Mg
Mg
OV
Mw
OV
OV
Oy
Th
zq
"}
(14,1,1) = {"
OV
OV
OV
OV
OV
OV
OV
OV
Mg
ue
dT
lR
lR
dg
LI
LI
Ji
Ji
OV
Th
xp
NM
OV
OV
zq
OV
OV
OV
Pc
Rt
LI
LI
qI
OV
"}
(15,1,1) = {"
OV
OV
OV
OV
OV
OV
OV
Mg
Mg
Mg
HT
bo
zj
sz
lR
Mj
LI
LI
Rt
Pc
Th
XR
XR
KD
Th
Mw
NM
NM
Fi
OV
LI
LI
Th
Th
"}
(16,1,1) = {"
OV
OV
OV
OV
OV
OV
OV
LK
LK
CO
Fq
xL
LI
MD
Pw
lR
MD
Mg
Fi
NM
XR
XR
XF
XR
Th
KD
Oq
NM
NM
OV
OV
Th
KD
OV
"}
(17,1,1) = {"
OV
OV
OV
OV
OV
OV
OV
ym
LK
CO
yQ
lR
dg
dg
lR
Ji
Ji
Ji
Pc
OV
XR
Oy
Th
Oy
Rt
Th
OV
NM
LI
em
Mw
Rt
OV
Rt
"}
(18,1,1) = {"
OV
OV
OV
OV
OV
OV
OV
Mg
Mg
Mg
Mg
Mg
OV
OV
OV
Mg
Ji
OV
Th
qI
XR
XR
LI
Qp
xL
Th
Th
Th
Mw
OV
OV
OV
OV
OV
"}
(19,1,1) = {"
OV
OV
OV
OV
OV
OV
OV
OV
OV
OV
OV
OV
OV
OV
Mw
OV
OV
OV
Th
qI
qI
Fi
LI
OV
OV
qI
Th
Th
LI
OV
Rt
Pc
OV
OV
"}
